hi, my doctor has come to the conclusion i have IBS after not showing any signs of chrons in a colonoscopy test.	NEGATIVE
I have every symptom of chrons however: Ab pain, bowel changes, bloating, pain, have had red eyes, sore on leg that change color when fading, mouth ulcers, etc	NEGATIVE
my question is has anyone been diagnosed with chrons after having a clear colonoscpy?	NEUTRAL
Sorry madam but I was diagnosed with it after my bloodwork, colonoscopy and biopsies came back positive.	NEUTRAL
Most people I have talked to that have Chrons also had the positive colonoscopys which sealed the deal.	NEUTRAL
Sorry.	NOT_LABELED
It is possible you have Crohns in the small intestine, which will not show on a colonoscopy, as this only looks at the large intestine (colon).	NEUTRAL
An upper endoscopy (to look at the esophagus, stomach and small intestine) is another test to rule out Crohns as biopsies can be taken of the tissue during the procedure.	NEUTRAL
Crohns often starts around the terminal ileum (next to the appendix) and can progress to the whole gastrointestinal tract (mouth to anus), as mine has done.	NEUTRAL
A barium swallow through is another test to see any problems in the upper gastrointestinal tract, but this is purely imaging, and biopsies cannot not be taken.	NEUTRAL
As far as I understand, the only conclusive proof of Crohns is biopsy of affected tissue, looked at by a pathologist.	NEUTRAL
IBS is a diagnosis of exclusion - after all available tests are completed and found negative for Crohns or Ulcerative Colitis.	NEUTRAL
It is not an IBD auto-immune disease and in my opinion, a lazy diagnosis by doctors who cannot be bothered to do proper evaluations.	NEGATIVE
Have you been tested for coeliac disease, as this can have similar symptoms to IBD?	NEUTRAL
Liz.	NOT_LABELED
I had something simular happen.	NEUTRAL
I had surgery in August to remove a mass in my small intestine, in the terminal ileum and they biopsy said high probability of Crohns.	NEGATIVE
However, when I had a colonoscopy and endoscopy 5 months later, it showed inflamation.	NEGATIVE
and ulcers throughout my small intestine but this time negative on the Crohns.	NEGATIVE
I do not really understand.	NEGATIVE
The doctor said I could still have it but been in remission during that time.	NEUTRAL
That makes no sense to me.	NEGATIVE
So we still do not know if I have it or not.	NEUTRAL
i have had biopsy that said yes and one that said no, I guess.	NEUTRAL
It just does not make sense to me.	NEGATIVE
Still, the prescription is the same whether I have it or not, steriods to clear up the ulcers and inflamation.	NEUTRAL
i am taking Entocort and Nexium.	NEUTRAL
The doctor told me as long as i am still feeling pretty good by this Summer then will not need to see him again unless I get symptoms again.	POSITIVE
He told me that doctors are reluctant to diagnose Crohns unless they know definitely it is Crohns because of insurance reasons.	NEGATIVE
I guess I can understand that.	NEUTRAL
Still, Id like to know if I have Crohns or if it is something else, what is it?	NEUTRAL
You know?	NOT_LABELED
I hope you get a diagnosis soon.	POSITIVE
I can understand your frustration.	NEGATIVE
I wish you well.	POSITIVE
Take care.	NOT_LABELED
thankyou both for your informative replies ...	POSITIVE
I have heard of people who have chrons in the small intestines ...	NEUTRAL
however when i asked my doctor whether or not this could be a possibility, he said if i had chrons it more than likely would have shown up in the bowel/colon and did not want to talk any further.	NEUTRAL
i feel very frustrated as i have looked into many chrons symptoms from people with chrons and have been through everything they have ..	NEGATIVE
i was overwhelmed to finally find someone else going through what i have ...	NOT_LABELED
i share your opinion of IBS being a lazy diognosis from a doctor ...	NEGATIVE
i just do not think you can be as sick as i have been and it be that ...	NEGATIVE
and do you have to be having an attack of chrons for the colonoscopy/ endoscopy to pick up a positive result ...	NEUTRAL
or can it be picked up when you are not showing any symptoms?	NEUTRAL
... .sounds like Aprils question!	NEUTRAL
anyway, is not it just great when you get better..	POSITIVE
have had 5 weeks of hell and am now feeling normal again!	POSITIVE
how are you girls feeling?	NEUTRAL
good to talk ...	POSITIVE
thanks for listening ,....saradan.	POSITIVE
( steph )	NOT_LABELED
Ok I know I said it wrong, but for the last 2 woman who posted, I was reading that there are 5 different Crohns, not sure of all but remember the most common was the ilieum, then lg intestines, then beggining of sm.	NEUTRAL
intestines the duednum, from mouth to anus.	NEUTRAL
and in some the jejelum, (where they can see with the endo capsule camera, but not with regular endoscope or colonoscope??	NEUTRAL
I was wondering about this myself??	NEUTRAL
Any responses at the jejelum would be appreciated.	POSITIVE
thanks, georgie.	NOT_LABELED
You can have Crohns Disease anywhere in your digestive tract, from your lips to your anus.	NEUTRAL
It is most common in the colon, but it is not exclusive.	NEUTRAL
Think of it as a mean thing living inside of you that can either attack one place or spread to another place, or MOVE to another.	NEGATIVE
This is why patients who have portions of their bowel removed, sometimes have Crohns pop up in a new part.	NEGATIVE
I would recommend getting a capsule endoscopy.	NEUTRAL
You swollow a camera in a pill that sends photos every three seconds to a machine that you wear around your stomach for the day.	NEUTRAL
It does not hurt at all and it eventually comes out naturally like anything else.	POSITIVE
trust me, when a doctor does a colonoscopy, he goes into the small intestines, most people with crohns has it in the iliuem.i got dignosed with crohns disease in the year 2000 ,.	NEUTRAL
and just last year got dignosed with ulcerative colitis and diverticulis.just got out of hospital in time to celebrate christmas, was in hospital 7 times last year with it not fun.if you feel you need a second oppion get one.	NEGATIVE
crohns can even affect the eyes.	NEGATIVE
my eyes look like there bleeding, my tongue has ulcers it goes all the way to my abdmion, mostly right side but affects left side and my back.kidneys are being affected.im going to the cleveland clinic for my crohns now.this is not a disease i wish uppon anyone, both of you sound like you need a second oppion.	NEGATIVE
I am in a similar situation and trying to get a second opinion at this point.	NEUTRAL
I have been having intestinal problems since 2002 and just a year ago got a doctor to finally find a colonoscopy necessary.	NEUTRAL
I was diagnosed from that with non specific non ulcerative colitis.	NEUTRAL
I suffer daily with mucousy diarhea, and abdominal cramping and pain.	NEGATIVE
Recently I develped a peri rectal abcess and fistula that I am seeing a colorectal surgeon for, who informed me that I had been misdiagnosed by the first gastrointestinal doctor because the only two conditions that can because that kind of fistula is crohns or ulcerative colitis.	NEGATIVE
I have only been treated for the currest symptoms with hyoscamine and another medication but I cannot remember what it was offhand...started with an L i think but I could not handle the side effects from it.	NEGATIVE
I am not getting much relief from the medications that I have been given.	NEGATIVE
I am also being treated by my general doctor for anxiety and depression disorder and for marijuana insomnia.	NEUTRAL
I really just think there is something much deeper going on here with all these different things going on.	NEUTRAL
Anyone have any ideas or suggestions?	NEUTRAL
I went undiagnosed for 12 years with Chrons.	NEUTRAL
I was always told I had IBS but I knew different I was too sick for that.	NEGATIVE
Through a colonoscopy there was some inflammation but they still did got get me a diagnoses (5 Colonoscopies later).	NEGATIVE
It was not until my doctor ran a specific blood test for Chrons that came back abnormal was I finally diagnosed with Chrons.	NEGATIVE
Be very insistent, we know our bodies better than any doctor out there.	NEUTRAL
If you know something is wrong keep pursuing it.	NEUTRAL
IBS not not include any inflammation internally and a fever and such.	NEUTRAL
Hope nobody ever has to wait as long as I did for help and treatment.	NEUTRAL
Ask your doctor for a said rate and CRP blood test.	NEUTRAL
Ask for a genetic test to be done on your blood.	NEUTRAL
Its expensive but conclusive.	POSITIVE
Crohns does not always show up in a colonoscopy.	NEGATIVE
Depends upon where it is located and that can change.	NEUTRAL
Prednisone is not for long-term therapy.	NEGATIVE
It destroys your teeth, muscles, tissues that can result in hip and shoulder replacements.	NEGATIVE
The disease ***** but you can control it with a positive attitude, healthy diet and proper medical care.	POSITIVE
I keep having rectal bleeding even though I use HC suppositories which help.	NEGATIVE
My colonoscopy and endoscopy came back negative for Crohns.	POSITIVE
Which blood tests do I need done to be sure?	NEUTRAL
i am on prednisone 10mg/day for one month for my asthma and need it to breathe better and relax.	NEUTRAL
I am in a similar position too ...	NEUTRAL
my problems started around two in a half years ago where i had extreme pain after eating any types of foods, followed by diarrhea ...	NEGATIVE
sometimes the pain was everyday, sometimes once a week but whenever it was it was so painful i would almost faint and could barely walk..	NEGATIVE
I started loosing weight, i have lost about 10kg since the pain first started.	NEGATIVE
My pains only come about once every 2months now because i am careful with the amounts i eat and how much of certain foods i can eat, i have learnt to read my stomach and when i need to stop eating in order to stop the pain from coming.	POSITIVE
I have lost my appetite and i rarely feel hungry.	NEGATIVE
Nearly every day i feel nauseous.	NEGATIVE
On the days i do not have diarrheoa i tend to be constipated, sometimes i do not go for days.	NEGATIVE
My stomach swells very easily too, half the time i look pregnant and i am a petite person.	NEGATIVE
I have been to a gastrologist for my problem and had tests upon tests.	NEGATIVE
I have had a colonscopy, endoscopy, blood tests, urine tests, stool tests and an xray and the only thing the doctor has found is that i am lactose intolerant which is far from the only problem i believe i have because even when i went on a lactose free diet for a month i was still experiencing the same problems, and now i pretty much eat lactose free butter, cheese, milk and yogurt.	NEUTRAL
Recently i also bleed from my bottom and skin came out from somewhere inside.	NEGATIVE
For a week after that i had mucus in my stool and now i keep getting anal fissures.	NEGATIVE
Has anyone else had a similar problem?	NEUTRAL
Can you still have Crohns if your IBD blood work came back normal?	NEUTRAL
A CT revealed thickening between my intestine and bowel.	NEUTRAL
The stomach pain gets me down so bad I cannot function.	NEGATIVE
I have felt pretty good the last few weeks with just mild cramping and diahrea.	POSITIVE
I have major joint pain and fatigue most of the time.	NEGATIVE
The nausea is very bad at times also.	NEGATIVE
I am an active person and these symptoms have slowed me down a lot.	NEGATIVE
I am scheduled for an upper and lower gastrointestinal next Wednesday ...	NEUTRAL
Any advice.... :	NOT_LABELED
Hi i am only 17 years old and I have been suffering with all the symptoms of chrones disease for three months straight now.	NEGATIVE
my aunty has chrones disease very bad also.	NEGATIVE
i have had numerous blood tests, urine samples, stool samples, an endoscopy, colonoscopy, MRI scan and EVERYTHING came back normal.	POSITIVE
Obviously its so frustrating and now they are putting it down to IBS.	NEGATIVE
Like you say, you know your own body better than anybody and it upsets me because I know it is something far more serious than that.	NEGATIVE
i have had lots of blood and mucus in my stools for four months without fail.	NEUTRAL
i have lost half a stone (and I am only 7 stone as it is) I sleep for days straight, I will not eat for days and the pain is unbearable the doctors prescribed me lots of codeine.	NEGATIVE
It gets me down that the doctors are leaving it to IBS because I know this is not the case.	NEGATIVE
Its horrible to think I may go 12 years living like this - it really puts a hold on reality: (thanks for all this advice it makes me feel better that there is people out there in the same position as me.	NEGATIVE
i have been suffering for 2 years.	NEGATIVE
i have had blood work, stool tests, endoscopy and colonoscopy all came back negative.	POSITIVE
My colonoscopy showed apthous ulcers in my descending colon but the biopsies came back normal.	NEUTRAL
My doctor said it would be unusual for crohns to be in that part of my intestines.	NEUTRAL
She said its usually in the small intestine.	NEUTRAL
I suffer pretty much everyday with colon pain and just a feeling of complete unwellness.	NEGATIVE
On the days I do not have a bowel movement I feel great but it seems like when I do have one, my whole body feels sick.	NEGATIVE
I also have loss of appetite at times adn some weight loss.	NEGATIVE
My doctor also told me that crohns is usually just diarrhea.	NEUTRAL
My stool is usually normal but it still makes me feel sick.	NEGATIVE
Can anyone tell me if this sounds like Crohns?	NEUTRAL
She thinks I have IBS but wants to do another colonoscopy to rule out crohns for sure.	NEUTRAL
Thanks for any help you can give me.	NOT_LABELED
My dr. just diagnosis me with crohns	NEGATIVE
I do not believe that this is my problem.	NEUTRAL
I have no signs of symptoms of crohns.	NEUTRAL
My sister, brother and son all have crohns so I know what to look for.	NEUTRAL
He did a colonoscopy and a scope down the throat (done on the same day).	NEUTRAL
The doctor . said everything was clear but he said he thought he seen an infection so he did 3 biops.	NEUTRAL
now he tells me that it is crohns and not my GB even though my GB is only working at 8% from a hida scan.	NEUTRAL
I still do not believe I have crohns but i do not know where to go from here.	NEGATIVE
He wants me to start on medicines for crohns and I am not ready to do this.	NEGATIVE
I need more proof.	NEUTRAL
Well, the most common area for Crohns disease to first strike is the terminal ileum which would be in the lower right quadrant.	NEUTRAL
HOWEVER, Crohns colitis is not at all uncommon (not the same thing as Ulcerative colitis) AND Crohns disease can strike ANYWHERE in the gastrointestinal tract from mouth to anus so....	NEGATIVE
Crohns disease is a very individualistic disease.	NEGATIVE
Most crohnies do enounter diarrhea, but there are plenty of use who encounter constipation.	NEUTRAL
My gastro likes to do colonoscopies too.	NEUTRAL
My Crohns struck first in the mid-ileum and there has not been involvement near the ileocecal valve.	NEUTRAL
So WHY would I put myself through that hor-eye-bull prep for a colonoscopy???	NEGATIVE
IF a barium upper gastrointestinal and SBFT does not give any answers, there is the CT Enterography, the MR Enterography and the Pill Camera Endoscopy.	NEUTRAL
I forgot: there is also the double balloon endoscopy (they get you from both ends and mark in the middle).	NEUTRAL
My fourteen year old has bad stabbing stomach pain to the right, below and above the belly button.	NEUTRAL
He had his appendix removed three months ago and they found imflamation around his ilium after colonoscopy they found several ulcers in his duedenal bulb.	NEUTRAL
The consult said it was not crohns after doing two enoscopy examinations and one colonoscopy.	POSITIVE
He is not gaining weight, is finding a lot of food makes the pain worse and gets very constipated - anyone have any ideas?	NEGATIVE
Angela.	NOT_LABELED
I feel bad for everyone that has to deal with this disease i have, ``"Ulcerative Colitis"'' ..	NEGATIVE
On 9-25-2012 at Memorial Hospital of Tampa i had asked my Doctor HJW is the difference between Ulcerative & Crohns Disease play a wider part in my case as to complications i may have as a result of a positive outcome on tests for Crohns (biopsy).	NEUTRAL
No sooner did i finish my question to him, did he say ``"i am not going to stand here and have you give me a F*****G course on anatomy and stormed out of my room.	NEGATIVE
So much for the ``"patients Bill of Rights"'' and or ``"Civil Rights"''.	NEGATIVE
I have since filed a Formal Complaint to the C.E.O., AHCA, Florida Department of Health Consumer Services Unit, Department of Civil Rights (OCR), Division of Quality Care, Office of the Chief Inspector General etc.	NEGATIVE
Next will be the Media.	NEUTRAL
They have stripped me of my self Dignity knowing full well that stress is already at it is peek level.Total Disregard for a human being under their care.	NEGATIVE
Hopefully some one with Administrative Power will have some morals to correct this nightmare he has inflicted upon me.	NEGATIVE
So much for private health care.	NEGATIVE
Anthem Blue Cross Blue Shield has turned a blind eye to this situation through informal complaint, but that is fixing to change through a formal complaint to their Medical Director.	NEGATIVE
Dr. HJW is accredited through them shame on them.	NEGATIVE
its a damn shame one should have to feel intimidated to further their care to recovery through the ones that treated you in the first place.	NEGATIVE
A speedy recovery to all above and beyond.	POSITIVE
J.C.	NOT_LABELED
i have been going through the whole diagnosis process for Chrons.	NEUTRAL
The colonoscopy did not show signs of it, but I had a polyp that he removed, and he took samples in my lg intestine for biopsy.	NEUTRAL
If they did not see it on the screen during the actual colonoscopy, can it still show up in the biopsies?	NEUTRAL
I have so many symptoms.	NEGATIVE
Abd pain, frequent bowel movements, feeling like I still have to go diarrhea, but nothing comes out and it hurts so bad.	NEGATIVE
I typically have about 6 BMs a day.	NEGATIVE
I have white discharge from my rectum, joint pain (knees, wrist), pain so bad that I have to take percocet and lay in bed in the fetal position.	NEGATIVE
I know something more serious than ibs is going on with me.	NEGATIVE
i have been so sick for about 4 months now.	NEGATIVE
I will get results from colonoscopy biopsies next week.	NEUTRAL
I pray they figure out what is going on with me!	NEUTRAL
I am experiencing the same thing!	NEUTRAL
Lost 20 pounds in less than a month and could not get out of bed for two.	NEGATIVE
My stomach hurts when it is empty but hurts more when I try to eat and I have to take a change of clothes with me everywhere I go because taking 2 plus Imodium.	NEGATIVE
does not help!	NEGATIVE
Have received negative results for Chrons, Addisons, Celiac and more so I must be OK, right?	POSITIVE
Have a new doctor who thinks it might be Inflammatory Bowel Disease.	NEUTRAL
Have to have an abdominal CT scan and more blood work.	NEUTRAL
Tired of taking pain pills but i am also tired of being in pain.	NEGATIVE
If ANYONE has ideas, please help!	NEUTRAL
I too am going through this for the past 4 years I have been having episodes of bloating, runs, pain in left side, night sweats and feel so unwell.	NEGATIVE
I get these large boils in my groin everytime my stomach is bad, my eyes are deteriorating, my joints all hurt, my ears are hurting and I am struggling to keep working.	NEGATIVE
This episode has been the worst I have had for a year and I am really struggling to get through it.	NEGATIVE
Had colonoscopy/endoscopy last week get results on Wednesday which can't come quick enough.	NEUTRAL
Just getting through each day at the moment is so so hard.	NEGATIVE
can't eat even drinking water makes me feel ill.	NEGATIVE
Am desperate for some answers am tired of being told its all normal aches and pains, nothing wrong with you.	NEGATIVE
Take antidepressants/valium god knows what else I have been given but its driving me insane.	NEGATIVE
What ever is going on is cruel and makes it harder not getting a doctor to find answers for me.	NEGATIVE
And doctors do not like to be told that you want certain tests done, its taken 3 years to insist on a Gastro referral from my GP and only got it because had blood in toilet.	NEGATIVE
Am hoping and praying (unlike me) that I get some answers wednesday or I will be devastated again.	NEGATIVE
I have been having this knive cutting pain in the middle of my stomach right behind my belly button.	NEGATIVE
I have had every test done possible: Colonoscopies, MRI, Cat Scans, Exploratory surgery, capsule endoscopy.	NEUTRAL
Every test I have had done comes back normal.	POSITIVE
I had the blood work done for Crohns and it came back negative.	POSITIVE
In 2012 my doctor retested me and it came back positive for a Crohns.	NEGATIVE
My doctor did not want to label me with this.	NEUTRAL
He said the test results should not change.	NEUTRAL
My primary doctor wanted to redo the blood work and the lab would not accept it because they said I was already labeled with Chrons and it would not change.	NEGATIVE
I just want to start on the medication to see if it will help.	NEUTRAL
I have read symptoms and have a friend with it and our symptoms are alike..	NEUTRAL
Any suggestions for me?	NOT_LABELED
Do you think I might have it?	NOT_LABELED
Pain is really bad after I eat.	NEGATIVE
I had a salad today and did not know what to do with myself because of the pain.	NEGATIVE
The only thing that helps is taking Oxycodone and using the heating pad.	POSITIVE
I am open for suggestions.	NOT_LABELED
Please help!	NOT_LABELED
Sara.	NOT_LABELED
I have been going through all of this for over 10 years . I have had multiple colonoscopys and endoscopys and ct scans mri exploratory surgery where I had 4ft of my small intestines removed.	NEGATIVE
I have severe abdominal pain all the time and cramps and blood in my stools and diarrhea and then times of constipation.	NEGATIVE
I have severe bloating and my eyes get watery and blurry at times.	NEGATIVE
I have been hospitalized for diverticulitis in the past for gastritis they have done all kinds of stool test and blood test all negative for crohns and all the biopsies have been negative, they did one expensive blood genetic test and if was inconclusive but indicated some kind of inflammatory bowel disease.	NEGATIVE
Have been referred to another specialist and fixing to have a gastric emptying test and mri entergraphy and HBT test and another colonoscopy and endoscopy and hoping that they would just find something that would come back positive so that they would treat me for crohn and stop telling me it is just ibs, i know my body and it is more than just ibs and i have never been more sicker or hurt as much as i do now.	NEGATIVE
I have been having symptoms of Crohns for 3 months and last year I had two other episodes with these same symptoms lasting 1-2 months.	NEUTRAL
IBD blood work is positive for Crohns.	NEUTRAL
CT scan and colonoscopy are negative, but endoscopy shows inflammation.	NEUTRAL
The doctor decided it was more likely it was just IBS, but I do not think I could be this sick for this long just from IBS.	NEUTRAL
Any thoughts?	NOT_LABELED
I think you need to find a new gastrointestinal doctor.	NEUTRAL
Its not ok to blow off a patient.	NEGATIVE
Find one who actually cares about your health and well-being.	POSITIVE
And insist on a camera endoscopy.	NEUTRAL
Its the only thing that can show what is really going on in your small intestine.	NEUTRAL
I just had it done yesterday and am waiting on the results.	NEUTRAL
i am fairly certain my doctor thinks I have Crohns even though most of my tests and biopsies have come back negative.	NEUTRAL
I, too, show all the symptoms (diarrhea, abdominal pain, mouth ulcers, joint and muscle pain, red swollen eyes, exhaustion ...), but they have not given me a definitive diagnosis or a treatment plan.	NEGATIVE
This has been a 3 month process of every test imaginable.	NEGATIVE
In the meantime, I have picked up a few books on the disease to help me get on a Crohns diet plan to help with the flare ups (half.com has many options for less money).	NEUTRAL
Maybe this will help you too?	NEUTRAL
Hopefully in another week Ill have my answers.	POSITIVE
Good luck to you friend!	POSITIVE
I am 38 years old.	NEUTRAL
I have been having symptoms of Crohns for 4 months.	NEUTRAL
I was send to do a fructan intolerance test.	NEUTRAL
I came positive to fructan intolerance.Then the doctor order some blood test IgA Ref (38.9) IgG (55.0) possible crohns disease.	NEUTRAL
Then he order a video capsule endoscopy with a finding of significant mid- and distal small bowel lymphoid hyperplasia.	NEGATIVE
Then he order a ct scan with results possible non-specific ileitis (demonstrate a thickened loop of the distal ileum which is nonspecific finding) now he order a colonoscopy with ileoscopy to due a biopsy.	NEGATIVE
He wrote that he what is to rule out lymphoproliferative process ...	NEUTRAL
I am supper worry.	NEGATIVE
I cannot sleep ...	NEGATIVE
what is going on?	NEUTRAL
Should I be supper worry?	NEGATIVE
Can some one explain what all this means?	NEUTRAL
Thanks for the help.	NOT_LABELED
The core of the problem is autoimmune, our immune keep atacking our body causes Ulcerative colitis or Crohn.	NEUTRAL
I got UC.	NEUTRAL
Before my immune attacked knees joint, ankylosing spondilitis.	NEUTRAL
I went to doctor but seems helpless because they kept trying to heal my joint.	NEGATIVE
The problem is the auto immune.	NEUTRAL
It happened 10 years ago.	NEUTRAL
Until I found mangosteen skin juice named xamthone (indonesia is my country) it helped a lot to control my immune and my joint healed by itself.	POSITIVE
I back to normal life and skip drinking xamthone mangosteen skin juice.	NEUTRAL
3 months ago I got hemorrhoid and fistula, hurt so bad!	NEGATIVE
I went to doctor and he heal me with 9 injection everyweek to my hemorrhoid and fistula, but he found there are put in my colon and giving me antibiotics levaquin for 7 days if pus is not gone yet he asked me to do endoscopy.	NEUTRAL
i am so afraid what happened to me since I felt better after my hemorrhoid cure.	NEGATIVE
Then I start search the internet and found that I got ulcerative colitis caused by auto immune.	NEUTRAL
I start to drink that mangosteen juice anymore and feel better.	POSITIVE
Autoimmune causes UC, UC causes hemorrhoid and fistula.	NEUTRAL
Before.	NOT_LABELED
Autoimmune causes joint disease ankilosing spondilitis.	NEUTRAL
So we need to control our immune and mangosteen skin juice help me (God showed me) I searched a lot and found that cabbage also helped.	POSITIVE
Control the autoimmune first!	NEUTRAL
Go chek the diseases that caused by autoimmune.	NEUTRAL
Hope it helps, Indonesia.	NOT_LABELED
I have the exact same problem I just had a endoscopy and colonoscopy done which came back normal I have a anal fissure I have been having this problem for about 12 years and they are still doing tests but I have not gotten blood work done that is my next thing to do because only you truly know your body and when something is not right.	NEGATIVE
I have recently been informed that I have suspected crohns disease and IBS.	NEGATIVE
I have had 2 colonscopies and various blood and stool tests.	NEUTRAL
I also have a diagnosis of Herpes simplex 2 and recently the episodes of IBS have increased as a result of my period, as have the herpes epsiodes- is there a direct link with herpes and IBS/Crohns and if so if I were to treat the herpes would this improve my bowel symptoms.	NEUTRAL
Thanks.	NOT_LABELED
I have the same problem, but from the information I have gathered is that herpes flare ups happen when our bodies are under stress.	NEUTRAL
I have to say having to go to the potty 5 to 7 times a day canker sores stomach cramps alternating constipation and loose/soft stools are very stressful.	NEGATIVE
if I find out anything different I will be sure to share please do the same I would love to know of any connection.	NEUTRAL
I think mine is type 1 I get them on my face.	NEUTRAL
On your face is herpes simplex1, in the genitalia it is herpes simplex 2.	NEUTRAL
I too have Crohns and have ``"cold sores"'' - herpes simplex1.	NEUTRAL
I have only once or twice had a breakout while also severely ill and in the hospital from the disease.	NEGATIVE
I see no direct link to the illness except that as emg454 mentioned, herpes reacts to stress.	NEUTRAL
When you are in a ``"major"'' flare up verses the everyday things that come with this illness, and anything else in your life that can be compounding the ``"stress situation"'' ie..family, kids, work, fear of losing job/medical benefits, possible surgery, etc ...	NEGATIVE
it all adds to the stress your body is under while trying to fend off the attack on our immune systems, therefore you could be susceptible to further outbreaks.	NEGATIVE
Hope this helps some.	POSITIVE
Kim.	NOT_LABELED
I just started a treatment regimen for the herpes i have cold sores.	NEUTRAL
My doctor is doing a medical study to see if this medicine will work.	NEUTRAL
He put me on acyclovir 800 mg 2 times a day and 15mg of meloxicam 1 x a day and gave me a sample pack of a pain medicine I cannot remember the name of it.	NEUTRAL
This is a surgeon in my area he is a very good doctor.	POSITIVE
He says my cold sores and my stress are directly related to my severe stomach/abdominal pain.	NEUTRAL
I had gastric bypass surgery last June 2011 before this I never had much stomach pain or cold sores.	NEUTRAL
I WANT TO KNOW CAN HERPES TYPE 2 BOTHER YOUR IBS?	NEUTRAL
I have been in a world of pain and discomfort for about a year now.	NEGATIVE
I am a gay man that thought I was careful, but appearantly not enough.	NEGATIVE
What I thought was an occasional about of hemmoroids, which runs in the family, turned out to not go away and become a major issue.	NEGATIVE
The doctors were baffled by my symtoms, and lightly asked if I have stuck something up my ***.	NEGATIVE
Of course I said no, but they said my symptoms looked like Crohns disease.	NEUTRAL
After a Colonocopy, they ruled that out.	POSITIVE
, which supriesd me because all my symptoms were spot on for Crohns.	NEUTRAL
My partner recently tested positive for herpes, because he had an outbreak, and had to get a painful circumcision, as a result.	NEGATIVE
So now, I have health insurance and the means to pay for treatment needed to get tested, which scares the **** out of me, to see if I have it, so I can get the right treatment.	NEGATIVE
But my symptoms have progressed since my last visit ...	NEGATIVE
now I have hemmroid-like protrusions around my anus that bleed, and burn lightly...on a good day, and I have dealt with this for a year, out of fear of doctors.	NEGATIVE
I have lived my life as a straight man and was even married to a wonderful woman...... be safe, no matter how much you trust someone ...	NEUTRAL
I feel like damaged goods now.	NEGATIVE
Take care.	NEUTRAL
I have been in a world of pain and discomfort for about a year now.	NEGATIVE
I am a gay man that thought I was careful, but appearantly not enough.	NEGATIVE
What I thought was an occasional about of hemmoroids, which runs in the family, turned out to not go away and become a major issue.	NEGATIVE
The doctors were baffled by my symtoms, and lightly asked if I have stuck something up my ***.	NEGATIVE
Of course I said no, but they said my symptoms looked like Crohns disease.	NEUTRAL
After a Colonocopy, they ruled that out, which supriesd me because all my symptoms were spot on for Crohns.	POSITIVE
My partner recently tested positive for herpes, because he had an outbreak, and had to get a painful circumcision, as a result.	NEGATIVE
So now, I have health insurance and the means to pay for treatment needed to get tested, which scares the **** out of me, to see if I have it, so I can get the right treatment.	NEGATIVE
But my symptoms have progressed since my last visit ...	NEGATIVE
now I have hemmroid-like protrusions around my anus that bleed, and burn lightly...on a good day, and I have dealt with this for a year, out of fear of doctors.	NEGATIVE
I have lived my life as a straight man and was even married to a wonderful woman...... be safe, no matter how much you trust someone ...	NEUTRAL
I feel like damaged goods now.	NEGATIVE
Take care.	NEUTRAL
Hey guys, if you have any questions that still need answers please post a new question so we can help you out.	POSITIVE
Thank you!	NOT_LABELED
Hi Guys, I see this is a really old thread, but I want to share the information I have on this matter as it s a top very close to my heart and I want to help anyone I can who is also struggling with these health issues ...	POSITIVE
I have struggled with IBS-C since I was a little girl, and contracted HSV2 about 5 years ago.	NEUTRAL
I have dealt with weekly, if not daily, herpes outbreaks since my contracting it.	NEGATIVE
I found when my gut acted up (pain, distention, bloating, constipation etc), I would get an outbreak within hours.	NEGATIVE
Even taking Valtex at 1G per day did not stop it.	NEGATIVE
I work out regularly, eat a whole foods diet and have seen a therapist regularly to manage stress.	NEUTRAL
Nothing helped, if anything it got worse over the years.	NEGATIVE
I have only recently, in the past year, found out that the underlying because of IBS is often a condition called SIBO (small intestinal bacteria overgrowth).	NEUTRAL
This is when bacteria that is only meant to be in the large intestine makes its way up in to the small intestine.	NEUTRAL
This can because damage to the mucosal lining of the small intestine as well as create gas, blasting, constipation, diarrhea, food intolerances, marijuana fatigue etc.	NEUTRAL
The reason this happens is due to low stomach acid, pancreatic exocrine function, and/or malfunctioning ileocecal valve.Bascially stress from emotions, food, drugs (recreational or pharma) all contribute to this problem.	NEUTRAL
The overgrowth of bacteria in the small intestine leads to a lot of endotoxins (waste) from the bacteria.	NEUTRAL
This waste damages the nerves surrounding in the gut leading to issues with motility (constipation, diarrhea), and weakens the immune system.	NEUTRAL
This is what lead to an opportunity for the herpes virus to express itself in me regularly.	NEGATIVE
It took me years to find this out.	NEGATIVE
I thought I was being punished and was always going to have this health situation, but luckily, I do not.	POSITIVE
To heal SIBO, you need to have a doctor or nutritionist supervise and provide a healing protocol via a diet called Low FODMAP"'', and one, to several rounds of either pharmaceutical or herbal antibiotics to rebalance the microbiome.	NEUTRAL
The low FODMAPs diet will reduce inflammation and help to starve the bacteria.	POSITIVE
Most find a huge relief in symptoms from cutting out high FODMAP foods alone, but that is only half the battle.	POSITIVE
You need the anti-microbials and re-inocculation.	NEUTRAL
Testing for SIBO is key.	NEUTRAL
You can do so through a Naturopath or Nutritionist.	NEUTRAL
Its important to know you have it for sure.	NEUTRAL
Keep in mind, studies are now proving that SIBO is the underlying case of IBS, and can be cured with patience and diligence.	NEUTRAL
So, the link between IBS and herpes is real.	NEUTRAL
IBS/SIBO severely weakens the immune system and creates the space of the virus to wreak havoc.	NEUTRAL
When you get the gut micrbiome under control, the virus will not have the same opportunities to express itself.	POSITIVE
I really hope this helps many of you struggling with this.	POSITIVE
I know it can seem like a hopeless issue and if I can add any other energy to this Id say; please take self-judgement out of the mix.	NEUTRAL
I know, easier said than done but at the end of the day it is just a virus.	POSITIVE
It does not define us.	NOT_LABELED
Self-judgment will only lead to more stress and we do not need more of that.	NEGATIVE
And there is someone out there that will fully accept you the way you are.	POSITIVE
I promise you that.	NEUTRAL
Stay positive, full of optimism and self-love and do not settle.	POSITIVE
You can heal these issues.	POSITIVE
xo.	NOT_LABELED
Before I was diagnosed with Crohns colitis in 2005, I was experiencing a lot of back pain which made it so I could not move around and I had never ever been in so much pain before!	NEGATIVE
One day I was sunning and I could not get up!	NEGATIVE
No matter which way I would try to help myself up I could not get up by myself.	NEGATIVE
My husband had to lift me up to help me.	NEGATIVE
This was the first thing that started happening to me before I started to get really sick with fevers, vomiting, diarhea, etc.	NEGATIVE
Hm, nobody out there have any input for me?	NEUTRAL
I hope all is well for you, I know a young person with crhons.	POSITIVE
Its horrible.	NEGATIVE
What is remicade?	NEUTRAL
Is that RA medicines?	NEUTRAL
My daughter just moved to KY from WV.	NEUTRAL
Beautiful down there!	POSITIVE
i have had crohns 30 years . Back pain has been my symptom on occasions.	NEGATIVE
Its sort of like back pain with child labor if you have had children.	NEUTRAL
Recently i have had lower back pain that feels almost like I strained my back.	NEGATIVE
It comes and goes.	NEUTRAL
Does any crampy feeling wrap around your side with the back pain?	NEUTRAL
i have crohns to i have had it for 14 years i am, like you i have bad..... back pain i went to the doctor and she said that i colud not take any thing for it but tylenol.	NEGATIVE
other drugs has inflammtorys in them.she said that that will make the crohns flarup.then i ask for pain pills and she said i did not need to take them.	NEUTRAL
i do not no what to do about all thatsome dr.s] i hurt all the time if you would like to email me you can i would like to talk to someone that has crohns to it is ginger_potter*** @ **** thank you, your frined ginger.	NEUTRAL
ok lets try this for the email *** @ ****	NOT_LABELED
ok heath61468 @ yahoo.com.	NOT_LABELED
Hi KentuckyBeMommaw, Before I was diagnosed I had the same problems.	NEGATIVE
Even to the extent of not being able to move after lying down.	NEGATIVE
I do not know if its connected to crohns e but I do know I had the same problems your describing.	NEUTRAL
Now its been a couple of years and I still have a tough time with my back but nothing like before.	POSITIVE
I also have a lot of joint pain!	NEGATIVE
That I am still trying to figure out what to do with.	NEUTRAL
I have not found any medicines that work well for me and I do not want to go back on steroids.	NEGATIVE
My recent flair up the dr. suggested steroids again but I chose to treat each complaint individually that is working for me so far (except for the joint pain).	POSITIVE
Have you heard any more about a connection between the two?	NEUTRAL
i have only be diagnosed with crohns for a year now but i am sure i have had it for years.	NEUTRAL
I only have crohns in my small intestine and I only get pain in the low right side of my back.	NEUTRAL
Almost like kidney pain.	NEGATIVE
But I am postive it has to do with my crohns because it only happens when I have flares.	NEUTRAL
iam only 27 i recently was diagnosed with crohnes after along few years first it was my gal bladder removed it.	NEUTRAL
nope now a year ago they diagnosed me with endometerosus, and sense then my doctors just kept saying it was that that was causing my lower back pain and abdomin.	NEGATIVE
i stay in so much pain.and have several doctors for every little thing.	NEGATIVE
i also have gerd and lactos intolerant.	NEGATIVE
i know i am young but it just seems like no one wanted to listin to me.	NEGATIVE
i have been in and out of the emergency room.	NEGATIVE
they have me on a few different medicines that i see no difference in.	NEGATIVE
they actully biopsied when they did my colonoscopy in november and it came back negative for crohnes but then i had to swallow a little capsel that is a camera to see inside my small intestines.	NEUTRAL
and he showed me the pictures and said they were ulcers in my intestines but never offer medicines for pain i finally asked for tramadole witch is useually used for fibermialga but it seems to help.	NEGATIVE
but doctors apparently do not like to give pain medicines but for people that have these kind of problems it should be necesary for all the people that abuse it now we can't even feel comfortable to ask i was so afraid to ask.	NEGATIVE
people should not be in that kind of pain.	NEGATIVE
but my doctor said that its only 80% right he says he's possitive its crones.	NEUTRAL
i also had a doctor tell me because i was bipolar he could not give me pain medicines.	NEGATIVE
because they have they tendency to be addictive/ i tell you i have seen a few doctors.	NEGATIVE
i have no faith in them.	NEGATIVE
i now go april 1st for a full hystarectamy because they think the pain again is from my endometerosis..	NEUTRAL
i hope i have had several test and scops and surgerys and now they think because i have crohnes that its gonna na complicate surgery there hopeing it will be in remission what ever that is suppose to mean.	NEGATIVE
i do not have flairs my pain never goes away for a year a half now.	NEGATIVE
i am hopeing this does help cross my fingers.	POSITIVE
GO TO A CHIROPRACTOR!	NEUTRAL
DO NOT START WITH PAIN medicines!!	NEGATIVE
I have had Ulcerative Colitis since I was 18 , 12 years now, and have been through every medication available.	NEUTRAL
Two weeks ago I had the most severe back pain ever and did not want to go to my regular doctor for pain medication.	NEGATIVE
There had to be something better than being on pain medication.	NEGATIVE
I was told by several friends to see a chiroprator.	NEUTRAL
THIS WAS THE BEST DECISION OF MY LIFE!	POSITIVE
I have been seeing a chiropractor for the last 3 weeks for my lower back pain, but I have noticed tremendous relief with my ulcerative colitis which was unexpected.	POSITIVE
I had always had discomfort in my lower back especially on my right side, like a pinched nerve feeling which made it very difficult to sleep on that side or even sit.	NEGATIVE
The pain I felt prior to going to the chiropractor was that same pinched nerve feeling put right in the middle of my lower back which effected both sides of my body.	NEGATIVE
After the x-rays my chiropractor took, I was shocked!	POSITIVE
There was a twist in my lower back that veered to the right (where all the pain of my colitis is located!	NEUTRAL
) I have been pain free since my adjustments and am on a 10 week fix plan.	POSITIVE
Everything in our body is linked to our spine, that is where all our nerves control other parts of our body.	NEUTRAL
I never would have put two and two together, but it has brought tremendous relief to me that I could never have imagined!	POSITIVE
Remember: You have nothing to lose by going to the chiropractor first.	POSITIVE
Surgeries and Pain medicines will stay with you for a lifetime!	NEUTRAL
Those should be your VERY LAST options!	NEGATIVE
I have had the disease for two years now and I have only had about 10 days where I have not had pain in my back legs knees shoulders and my abdomen without taking any medicines.	NEGATIVE
I was taking 16 pills a day to clam down the back pain along with my burning sensation in my abdomen.	NEGATIVE
Finally I took Tramodol and that saved my life.	POSITIVE
If I do not take it when I get up the pain in my back, abdomen, pelvis and knees kills me.	NEGATIVE
I work in surgery and I have to walk and stand on really hard floors so that does not help at all.	NEGATIVE
I hate waking up in the morning with a burning sensation in my abdomen and the pain and weakness I occur when I sleep for more than 5 hours at a time.	NEGATIVE
I went to a chiropractor and he really really screwed up my back.	NEGATIVE
He hurt me more than I could imagine.	NEGATIVE
So I started to go and get a message once a week and that helps a lot with my lower back pain.	POSITIVE
I have been on pentasa for the last 2 years and I think my body has become acustomed to the dosage and I have had 5 flair ups since January.	POSITIVE
I just got off a 3 month course of steroids and I felt wonderful for about 1 month now i am back to the back pain, joint pain, the bloating abdomen pain and flair ups!	NEGATIVE
I hate it.	NEGATIVE
My Crohns doctor is best friends with my husband and he still cannot help me.	NEGATIVE
I think its a wicked disease that no one really understands and if you do not have it you do not really understand the pain that is involved with crohns.	NEGATIVE
I have to live on Tramodol or else i am in constant pain.	NEGATIVE
I have to go off the tramodol for periods of times so I do not get addicted to it.	NEGATIVE
And its those times I hate even moving!	NEGATIVE
I hope my story can help those who have had these problems with Crohns.	POSITIVE
I do not think anyone will find a cure as of yet but time will come and maybe there will be light at the end of the tunnel.	POSITIVE
For now I take pain medicines to help with the pain if I do not take them my life is pretty hard.	NEGATIVE
Hey All, My name is Steve.... I have been diagnosed with Crohns about 14 years ago.	NEUTRAL
did not have insurance so let it get really bad.	NEGATIVE
Had 8-12 bowel mvmnts a day and thought I was in remission.	NEGATIVE
How stupid of me.	NEGATIVE
Got married ...	NEUTRAL
got insured ...	NEUTRAL
went to see one of the best Gastros in Chicago.	NEUTRAL
He asked how I was feeling.	NEUTRAL
I told him everything and he said I was crazy.	NEGATIVE
He scoped me and my CR is very inflamed.	NEGATIVE
Put me on Prednisone for 2 months and Imuran indeffinatly.	NEUTRAL
I went from 8-12 BM to 1-2 (talk about stupid ha?) Feeling great, but had to go back for another colonoscopy.	POSITIVE
I was positive everything was peachy-dory.	POSITIVE
doctor comes out says I am still inflamed and have strictures (intestine thickening and slowly closing).	NEGATIVE
So now he prescribes Humira ...	NEUTRAL
I FREAK OUT.	NEGATIVE
He is bringing out the big guns.	NEGATIVE
I now find out that my insurance does not cover it AT ALL.	NEGATIVE
My doctor who works in a University setting and is the Founder of the Illinois IBD Society is PISSED.	NEGATIVE
Meanwhile puts me on Entocort.	NEUTRAL
Everything is still great only now I cannot sleep.	POSITIVE
I figured probably just nervous about all the new drugs.	NEGATIVE
After sleeping about 5 hours in 4 days I gave up and called the doctor.	NEGATIVE
He lowers my Entocort and prescribes antiaxiety (xanax-like) medicines.	NEUTRAL
I started sleeping better.	POSITIVE
Slowly coming off Entocort, and still not understanding why I am going through all of this when I am feeling just fine.	POSITIVE
( My wife is a resident and explained that I need to do what the doctor says).	NEUTRAL
I get a message on my cell about 3 weeks ago from my Gastro doctor (can we just agree that this doctor is amazing) saying that he just got back from a meeting and met an executive from Abbott laboratory results who said I maybe eligible for an assistance program.	POSITIVE
I fill out a ton of forms, answer a bunch of questions and found out I am getting Humira for a year for free.	POSITIVE
Starting in a week.	NEUTRAL
Now I am starting to freak out about Humira...... . SO..... Any suggestions on how to keep my Immune system working???	NEGATIVE
I hope all you guys who are doing well keep well and those of you who are suffering to get better.	POSITIVE
Be aware that there are some types of arthritis that can go along with inflammatory bowel disease.	NEUTRAL
Insiste on being seen by a rheumatologist and having a complete blood work up and exrays.	NEUTRAL
There are treatments, other pain relief medicines, and chiropractor or massage can help but it is important that the because is treated, not just the symptoms.	NEUTRAL
Quick suggestion - Yes I suffer from Crohns however i have just had the best blood results i have ever had.	POSITIVE
No i am not in remission and yes I still suffer (particularly as I have already lost 5% of my spine mobility due to a previous accident).	NEGATIVE
However the only thing i have done different since my last blood test is i have been eating a couple of handfuls of pepitas (pumpkin seeds - unsalted / unflavoured - just ``"roasted"'') a day - they have helped to reduce the inflammation - worth a try.....mind you - my back is killing me again at present and Ill do stretches etc to get it moving - i refuse to let this disease win.	POSITIVE
Hi I have been diagnosis with crohns for 9 yr. but Dr. have think i have had it since i was 15 year now i am 30yr.	NEUTRAL
Well anyways i do have back pain very bad a times (a long with all the other things that come along with this horrible disease).	NEGATIVE
I have done some research on this what i have found It could be caused by inflammation of sacroiliac joint it in your back it called sacroiliitis or inflammation what the because of other joints in that area.	NEUTRAL
2nd muscle tension due to bowel inflammation 3rd osteoporosis due to poor absorption.Every place i looked said same thing, it maters what the because is depends on treatment either medicines message chiropractor hot bath.Hope this helps i feel your pain Good luck hope it get better.	NEUTRAL
like the other posters suggested go see a Rhuematologist as soon as possible.	NEUTRAL
I struggled with back pain for years with my Crohns disease.	NEGATIVE
I saw surgeons, chiropractors, pain doctors, everything and nothing worked.	NEGATIVE
Went to a Rhuematologist she immediately diagnossed me with an arthritis that was common in Crohns patients and put me on medication that worked immediately and now I am pain free in my back.	POSITIVE
Luckily my uncle is a doctor and he is the one that suggested I see a Rhuematologist because I was considering having back surgery.	POSITIVE
Hope you feel better and hope this helps!	POSITIVE
Christine.	NOT_LABELED
like the other posters suggested go see a Rhuematologist as soon as possible.	NEUTRAL
I struggled with back pain for years with my Crohns disease.	NEGATIVE
I saw surgeons, chiropractors, pain doctors, everything and nothing worked.	NEGATIVE
Went to a Rhuematologist she immediately diagnossed me with an arthritis that was common in Crohns patients and put me on medication that worked immediately and now I am pain free in my back.	POSITIVE
Luckily my uncle is a doctor and he is the one that suggested I see a Rhuematologist because I was considering having back surgery.	POSITIVE
Hope you feel better and hope this helps!	POSITIVE
Christine.	NOT_LABELED
Back pain prior to being diagnosed with ulcerative colitis.	NEGATIVE
Doctor suspected it was colon related about 5 years before my diagnosis.	NEUTRAL
Every few years I would have lower abdominal discomfort or lower back pain which was intermittent, until eventually experiencing the ulceration and inflammation of the colon which lead to my diagnosis.	NEUTRAL
medicines seem to control symptoms thus far.	POSITIVE
I have very bad back pain and I am going to my gasrto today, I was in remission for about 3 year, after surgery but now its back and I have cramping and back pain, I just can't stand it anymore.	NEGATIVE
The dr. said I did not have Crohns but Ulcerative colitis, but i have been having the same pain you are describing.	NEUTRAL
I already have been dealing with back pain for years, but you are right...this feels like child labor back pain.	NEGATIVE
Happens all the time with me since I have not been in remission since it started in April.	NEGATIVE
I thought I was going crazy for a while.	NEGATIVE
have blood work to check for celiacs.	NEUTRAL
have crohns 30yrs but also sprue what do you want to know.	NEUTRAL
check for ostioporsis.	NEUTRAL
find another doctor your only hope.	NEUTRAL
i am 33 just diagnosed 6 months ago with Crohns.So they put me on buspar and ultram.	NEUTRAL
Well it caused me to have seizures.Well the best part is had back surgery 10 years ago.Go to the hospital messed up several disks and have damaged nerves.Now I have bursitis in my hip, caused by Crohns.Im on so many medicines, and.	NEGATIVE
I think this is my life to I die.Im saying this because I have no one to talk to that really understands me.	NEGATIVE
Anyone that really knows Crohns please email me at *** @ ****	NEUTRAL
Has any doctor thought of Fibromyalgia?	NEUTRAL
Lyrica & Vitamin D3 seem to help me.	POSITIVE
Anyone out there changed their diet?	NEUTRAL
It worked wonders for me.	POSITIVE
I went to an herbalist who had me change my diet and also had me do a colon cleansing.	NEUTRAL
i have been off of medication for over 6 years.	POSITIVE
Hi Christine, my boyfriend is in the same situation, can i ask what medication your rheumatologist prescribed?	NEUTRAL
thanks for sharing.	NOT_LABELED
Stephanie.	NOT_LABELED
I am so sorry to read about everyones pain.	NEGATIVE
My sister in law was recently diagnosed with crohns disease and she is having a lot of back pain.	NEGATIVE
I was hoping to find some advice for her, but apparently you folks are just as desperate as she is.	NEGATIVE
I wish you all relief from your pain.	POSITIVE
Hello, I was just diagnosed with Crohns.	NEUTRAL
They just put me on Pentasa 8 pills aday of 500mg each.	NEUTRAL
Wow @ @ The pain has not stopped, but hoping it will work.	NEGATIVE
I do take Vicadon only when the pain causes me to cry and I cannot move or sit or lie down, and sometimes it does not work.	NEGATIVE
I have had MRIs to make sure it was not something else.	NEUTRAL
Yes, all this pain comes from having Crohns.	NEGATIVE
I hope someday they will find something that would not kill of something else helping Crohns.	POSITIVE
Also when things become so bad, I take a sleeping pill and muscle relaxer, that helps.	POSITIVE
It has change my life from this active, sport driven love to a person I do not know.	NEGATIVE
Like another poster, I completely changed my diet & lifestyle.	NEUTRAL
It has literally transformed me.	NEGATIVE
Imuran, prednisone, humira, acsacol ...	NEGATIVE
Been on all of them.	NEGATIVE
They only suppress the immune system & mask the problem, not the root of the problem: the SAD, toxins, pesticides, etc . poisoning our bodies for yeas.	NEGATIVE
Carons is not a disease, it is a symptom of poor health via poor nutritious and toxins over time.	NEGATIVE
You need to clean up the body to get well and stay well.	NEUTRAL
I now eat all organic (even when I cheat and have a cookie (rare) it is organic) cut out sugar (most important), dairy, gluten, and processed foods.	NEUTRAL
Am off SAD (standard American diet) and onto a paleo (anti-candida/anti-inflammatory) diet.	NEUTRAL
THE RIGHT FOOD IS MEDICINE.	POSITIVE
So are the right fats (virgin cold-pressed coco it oil, cod, fish, primrose, flax oils) and ACV (apple cider vinegar).	POSITIVE
google all.	NEUTRAL
Also google Edgar Casey.	NEUTRAL
He knew this 100 years ago.	NEUTRAL
Great resource: -URL-and do not forget prayer.	POSITIVE
There is great power in prayer.	POSITIVE
God bless you all.	POSITIVE
i also only experience such terrible lower back pain just before a flare up, usually a terribly immobilizing cramping session.	NEGATIVE
sometimes it has a cold feeling pressure, almost like the coldness associated with numbing, but it is not numb at all, and has a stiff, sore feeling.	NEGATIVE
The back pain almost makes me naucious ...	NEGATIVE
the crohns cycle!	NEGATIVE
does anyone else experience this?	NEUTRAL
i am 18 and was diagnosed at 16.	NEUTRAL
i have had symptoms since i was a very young child.	NEUTRAL
i also only experience such terible lower back pain just before a flare up, usually a terribly immobilizing cramping session.	NEGATIVE
sometimes it has a cold feeling pressure, almost like the coldness associated with numbing, but it is not numb at all, and has a stiff, sore feeling.	NEGATIVE
The back pain almost makes me naucious ...	NEGATIVE
the crohns cycle!	NEGATIVE
does anyone else experience this?	NEUTRAL
i am 18 and was diagnosed at 16.	NEUTRAL
i have had symptoms since i was a very young child.	NEUTRAL
I feel so bad for you.	NEGATIVE
I suffer with ulcerative Colitis for most of my life.	NEGATIVE
I am 53 now and some times are better than others.	NEUTRAL
I have flare ups and sometimes long remissions.	NEUTRAL
I take asacol HD 3x day and enticort.	NEUTRAL
It does not help a lot when the flare ups are at their worst.	NEGATIVE
do not ever give up although I do feel that way at times.	POSITIVE
that is when I realize the disease has taken control.	NEGATIVE
It is up to us to take control and continue with life.	NEUTRAL
I have 2 boys ages 12 and 15, along with 2 foster boys ages 4 and 7.	NEUTRAL
They all need me and I need to be there for them.	NEUTRAL
Medical technology has come so far and even there is no cure yet for our disease I keep the hope.	POSITIVE
It has been a while since your post and I hope you are doing better as I write this.	POSITIVE
To all of us suffering, PLEASE never give up.	POSITIVE
It will get better!	POSITIVE
I found what you have written interesting.	POSITIVE
I am a 28 year old male.	NEUTRAL
I have been suffering from Crohns for about 2 years.	NEUTRAL
They tried every oral medicine out there nothing worked.	NEGATIVE
Asacol is the only one I can name now.	NEUTRAL
Then they brought the big dogs out and I started Remecade.	NEUTRAL
The first go about I had no reaction.	POSITIVE
The second time though my blood pressure sky rocketed, as well as my heart rate.	NEGATIVE
That was the last time for Remecade.	NEGATIVE
After that I ended up being so bad I had emergency surgery for an abscess on my colon.	NEGATIVE
I had reconstructive bowel surgery and had to wear an ileostomy bag for six months.	NEGATIVE
The reversal went well.	POSITIVE
Felt good for a few months, then another flare up.	POSITIVE
Now I am starting Cimzia.	NEUTRAL
I just took my first injection yesterday.	NEUTRAL
I really want to change my entire diet.	NEUTRAL
I have been reading a lot about SCD.	NEUTRAL
Simple Carbohydrate diet.	NEUTRAL
Should I keep taking the medication and change my diet at the same time?	NEUTRAL
I am really confused.	NEGATIVE
just wanted some advice.	NEUTRAL
thank you.	NOT_LABELED
Can you share what medication that was that helped you?	NEUTRAL
I was diagnosed with Crohns 5 years ago.	NEUTRAL
After high dosage of prednisone and infusions it went away.	POSITIVE
I thoguht I was home free but 5 years later its back with avengence.	NEGATIVE
Nothing is working.	NEGATIVE
This time its really bad and I feel scared.	NEGATIVE
doctor tells me our next step is remicade, humira etc.	NEUTRAL
After researching I do not feel comfortable with trying any of those.	NEGATIVE
It seems that it may help with the crohns but start a whole new diesease to tackle.	NEGATIVE
My husbands co-worker suggested that I should try aloe vera juice.	NEUTRAL
So I picked up some two days ago.	NEUTRAL
Have been drinking 6 ounces daily since.	NEUTRAL
I feel something is happening....stomach feels quiet.	POSITIVE
Although I still have the runs but not as much.	POSITIVE
I hope this is the start of a miracle!!	POSITIVE
If this helps.....Im planting aloe vera all over my yard!!!!! Since I have been there and know what it is like to go through life with crohns and other realted issues, I would like to give a cyber hug to all who are going through this.	POSITIVE
Breath through the pain and stay positive.	POSITIVE
Keep researching and do not be shy to vent.	NEUTRAL
Sometimes help comes from the least expected source!	NEUTRAL
Love You All!!!	POSITIVE
My brother-in-law has Crohns and a gluten free diet made him 90% better.	POSITIVE
Unlike you, he suffers from it all the time.	NEGATIVE
Maybe something for you to try.	NEUTRAL
Hi, My name is bridget.	NOT_LABELED
I am 25 years old and have Ulcerative colitus of course Crohns is its cousin they are so alike.	NEUTRAL
Let me tell you you are in the right step of healing process ALOE VERA?	POSITIVE
I have herd good things about it.	POSITIVE
it helps ease pain bloating, bleeding inflammation in the rectum.	POSITIVE
Its a natural medicine sent from god.	POSITIVE
I truly believe in natural remedies because i am sick of medicine like asacol, Colazol, predisone they just worsen your symptoms.	NEGATIVE
I have been off them for 1 years now and use natural herb remedies like aloe vera from forever living also fenugreek and organic probiotics.	POSITIVE
Fenugreek is a natural herb plant from india that helps with gastrointestinal disorders I drink that everyday before foods early morenings.	NEUTRAL
I discovered it through a Chinese doctor that studied natural medicine and herbs from china for many years.	NEUTRAL
Let me say that I feel great they are miracle workers..	POSITIVE
The best of luck to you.	POSITIVE
The start of a miracle will end up a miracle!	POSITIVE
Thank you for the reply.	NOT_LABELED
i am willing to try anything which is not toxic to my health.	NEUTRAL
I have heard about gluten free diet.	NEUTRAL
Maybe I will go ahead and try it along with aloe vera juice.	NEUTRAL
Thanks: )	NOT_LABELED
Thank you for the reply.	NOT_LABELED
i am so happy for you!	POSITIVE
I can't wait to feel better again soon!	POSITIVE
Aloe vera has made me 60% better in one week.	POSITIVE
It has cut down my bathroom visits to half.	POSITIVE
The pain has calmed down a little.	POSITIVE
After this i am headed out to find me some gluten free eats and fenugreek.	NEUTRAL
I appreciate your help and support :) Thanks!	POSITIVE
Went shopping over the weekend and found this herbal tea.	NEUTRAL
Its called Mothers milk.	NEUTRAL
Its made with fenugreek seeds!	NEUTRAL
Although I felt weird buying something which is for healthy lactation (since i am not nursing), I want to get the other benefits from fenugreek seeds.	NEUTRAL
Straight up fenugreek tea was too bitter but this one is little mild and i am able to consume it better.	POSITIVE
i am still continuing the aloe vera regimen.	NEUTRAL
It has helped a great deal and I hope this tea will help finish the job.	POSITIVE
Staying hopeful: )	POSITIVE
Hi guys.	NOT_LABELED
I was diagnosed with ulcerative colitis last year and i am having a terrible time of it at the moment.	NEGATIVE
Steroids worked but doctors have taken me off them as they say i am too young to go on them full time.	NEGATIVE
I am 32.	NEUTRAL
I have heard lots of good things about aloe vera.	POSITIVE
Should i buy an aloe vera drink or capsules?	NEUTRAL
Many thanks.	NOT_LABELED
Charlotte.	NOT_LABELED
hey- I was diagnosed with UC 2 years ago, and I have been on steroids almost just as long.	NEUTRAL
I am younger than you are, now 25, but started them when I was 23.	NEUTRAL
If the steriods work I would stay on them until you get your UC under control.	POSITIVE
At one point I used aloe vera, and it just made things worse.	NEGATIVE
I told me doctor I was taking it and she said that it causes you to go to the bathroom, that is how it ``"cleanses"'' your body.	NEGATIVE
So i stopped it.	NEUTRAL
There are other medications out there for UC, have you tried 6MP or Imuran, they are pills?	NEUTRAL
Personally, it had side effects, but everyone else I have talked to, or read about, especially on this site, has had amazing results with it.	POSITIVE
If you are not on steriods right now, it would be a good time to try it so you would not have to be taken off of them again.	POSITIVE
Other medications that I have heard that have worked well for other people are Humiera and Remicade.	POSITIVE
The last to are a self injection, and an infusion, respectively.	NEUTRAL
Hey Cheekecharlie!	NOT_LABELED
I have been taking aloe vera juice.	NEUTRAL
I have heard about the capsules but have not tried them.	NEUTRAL
I was thinking to get some but the juice has completely turned my life around in a month!	POSITIVE
i am all better and feel great at this point.	POSITIVE
If you are taking any mesalmine (Lialda etc) tablets....I would suggest you keep taking them too.	NEUTRAL
I drink the juice first thing in the morning and with dinner and one small dose right before bed.	NEUTRAL
About 3 ounces at AM and 3 ounces with dinner and 2 ounces before bed.	NEUTRAL
Good luck!	NOT_LABELED
I been diagnosis with crohns disease but I will not take any medication because I feel great drinking aloe vera every morning just blend with honey and lemon you will see is a miracle ...	POSITIVE
i have been taking AMP (Aloe Muciaginous Polysaccarides) for ten months.	NEUTRAL
I have had incredible success in gaining remission from crohns.	POSITIVE
I now lead a normal life free of the hell crohns put me through.	POSITIVE
Great not to have the awful side affects of steroids, methotrexate,6mp.	POSITIVE
AMP is the healing molecules which is extracted from Aloe (my understanding).	NEUTRAL
I came across it on you tube when i viewed a testimonial by a girl in the US (Jennifer) & a guy in the UK (keith).	NEUTRAL
It was not cheap when i started but i now take 3 capsules p/d its reasonable.	POSITIVE
ALL OF YOU STAY AWAY FROM THE ALOE VERA ESPECIALLY ANYONE ALLERGIC TO LATEX!!	NEGATIVE
Latex: The most serious difficulties encountered with aloe latex occur at higher than recommended doses or when used for more than a few days.	NEGATIVE
This laxative herb causes the loss of potassium and other minerals, which over time can result in a loss of muscle tone of the intestine and diminished effectiveness.	NEGATIVE
Frequent use may because irreversible damage.	NEGATIVE
Large doses of aloe have caused bloody diarrhea, kidney damage, and even death.	NEGATIVE
The urine may take on a reddish color after taking aloe latex.	NEGATIVE
This color is harmless; however, with the possibility of kidney damage from large doses or prolonged use, any persistent color in the urine may call for medical diagnosis.	NEGATIVE
Aloe gel is LIKELY SAFE when applied to the skin and POSSIBLY SAFE when taken by mouth in adults.	NEUTRAL
Once in a while aloe gel might because burning and itching of the skin.	NEGATIVE
Taking aloe latex is POSSIBLY UNSAFE at any dose, but LIKELY UNSAFE when taken in high doses.	NEGATIVE
Aloe latex can because some side effects such as stomach pain and cramps.	NEUTRAL
Long-term use of large amounts of aloe latex might because diarrhea, kidney problems, blood in the urine, low potassium, muscle weakness, weight loss, and heart disturbances.	NEUTRAL
Taking aloe latex 1 gram per day for several days can be fatal.	NEGATIVE
There have been a few reports of liver problems in some people who have taken an aloe leaf extract; however, this is uncommon.	NEUTRAL
It is thought to only occur in people who are extra sensitive (hypersensitive) to aloe.	NEGATIVE
Special Precautions & Warnings: Pregnancy or breast-feeding: Aloe--either gel or latex--is POSSIBLY UNSAFE when taken by mouth.	NEGATIVE
There is a report that aloe was associated with miscarriage.	NEGATIVE
It could also be a risk for birth defects.	NEGATIVE
Do not take aloe by mouth if you are pregnant or breast-feeding.	NEGATIVE
Children: Aloe is POSSIBLY UNSAFE for children when taken by mouth.	NEGATIVE
Children younger than 12 years old may experience abdominal pain, cramps, and diarrhea.	NEUTRAL
Diabetes: Some research suggests aloe might lower blood sugar.	NEUTRAL
If you take aloe by mouth and you have diabetes, monitor your blood sugar levels closely.	NEUTRAL
Intestinal conditions such as Crohns disease, ulcerative colitis, or obstruction: Do not take aloe latex if you have any of these conditions.	NEGATIVE
Aloe latex is a bowel irritant.	NEUTRAL
Remember, products made from whole aloe leaves will contain some aloe latex.	NEUTRAL
Hemorrhoids: Do not take aloe latex if you have hemorrhoids.	NEGATIVE
It could make the condition worse.	NEGATIVE
Remember, products made from whole aloe leaves will contain some aloe latex.	NEUTRAL
Kidney problems: High doses of aloe latex have been linked to kidney failure and other serious conditions.	NEGATIVE
Surgery: Aloe might affect blood sugar levels and could interfere with blood sugar control during and after surgery.	NEGATIVE
Stop taking aloe at least 2 weeks before a scheduled surgery.	NEUTRAL
Applying aloe vera gel is considered safe, but consuming unprocessed juice extracted from the latex can because several side effects leading to major health risks.	NEGATIVE
Some of the side effects of aloe vera juice are :	NEUTRAL
1 . Aloe vera juice contains a substance called anthraquinone, a laxative, which can because diarrhea if taken in large amounts.	NEUTRAL
Severe diarrhea can because pain, cramps and dehydration.	NEUTRAL
2.Consult your doctor before consuming aloe vera juice, especially if you are undergoing a medical treatment or taking prescribed drugs, as the juice may because adverse reactions when consumed along with few medicines.	NEGATIVE
Laxative in aloe vera may even inhibit the absorption of some drugs in the body.	NEUTRAL
Aloe vera juice also reacts to herbs like jalap roots, castor oil, rhubarb root and bark root, causing dehydration and diarrhea.	NEUTRAL
Fenugreek and garlic do not digest well with aloe juice; it can lower blood sugar and potassium levels in the body.	NEGATIVE
3 . Drinking aloe vera juice can result in allergic reactions like skin rash or hives, itchy or swollen skin, difficulty in breathing, chest pain and throat irritation.	NEUTRAL
4 . Aloe vera juice contains latex, an ingredient which has many health risks associated with it.	NEGATIVE
It can aggravate health problems like colitis, Crohns disease, appendicitis, diverticulosis, intestinal obstruction, hemorrhoid, stomach pains and ulcers.	NEGATIVE
There are also reports which suggest of hepatitis caused by consumption of aloe vera juice, becoming a because of concern for people with liver problems.	NEGATIVE
5 . Pregnant and lactating women are strictly forbidden from consuming aloe vera juice, due to its purgative and irritant qualities.	NEGATIVE
It may stimulate uterine contractions in pregnant women, leading to miscarriage and birth defects.	NEUTRAL
Lactating women should also refrain from consuming aloe vera juice, as it contains anthraquinone which may lead to diarrhea.	NEUTRAL
It is also considered unsafe for children below 12 years of age.	NEGATIVE
6 . People, who suffer from irritable bowel syndrome and gastrointestinal problem, should not drink aloe vera juice, as it contains high amount of laxatives which can increase the severity of the problem.	NEGATIVE
7 . Drinking unprocessed aloe vera juice can because dehydration and electrolyte imbalance in the body.	NEUTRAL
It also changes urine color to pink or red in color.	NEUTRAL
8 . Consumption of aloe vera juice can lead the body to produce excessive amounts of adrenaline, which can be harmful for people suffering from heart conditions.	NEGATIVE
It can also lower potassium levels in the body, causing irregular heartbeats, weakness and soft muscles.	NEUTRAL
Hence, it is not recommended for children and elderly people.	NEGATIVE
9 . Consuming aloe vera juice, for more than a year can because pseudomelanosis coli, a condition which increases the risk of colorectal cancer.	NEUTRAL
There are even possibilities of developing carcinogenic risk if consumed in high amounts.	NEGATIVE
10 . Aloe vera juice helps to lower blood sugar levels by decreasing insulin resistance in the body.10 ,	NEUTRAL
Thus, people who are undergoing treatment for hypoglycemia or diabetes should consult their physician before consuming aloe vera juice.	NEUTRAL
11 . Overdose of aloe vera juice can because blood build-up in the pelvis, which leads to kidney damage.	NEUTRAL
12 . Prolonged usage of aloe vera juice can increase the risk of constipation.	NEUTRAL
Also, intake of aloe latex can because depletion of the potassium from the cells of the intestinal lining.	NEGATIVE
I too have Crohns Disease.	NEUTRAL
i have had it for 16 years.	NEUTRAL
I went from the mildest case my Gastroenterologist has ever seen to, in his words, become his problem child.	NEUTRAL
I have been on all the pills including Entocort with a daily Folic Acid.	NEUTRAL
Crohns affects everyone differently so the treatments do as well.	NEUTRAL
Unfortunately the treatments only work for a finite amount of time.	NEGATIVE
Your body will start to resist them.	NEGATIVE
Do your research.	NEUTRAL
Talk to your Gastroenterologist.	NEUTRAL
If you are not being managed by one I strongly suggest going to see one.	NEUTRAL
I have been on most of the biologics such as, Humira, Cimzia, Remicade.	NEUTRAL
They do lower your immune system so you need to avoid people who are sick.	NEGATIVE
There are side affects but they are minimal compared to the side affects of Crohns.	POSITIVE
The best advice I could give is to watch what you eat, make a good diary of what you eat and when and how it makes you feel, also include how it affects your bowel movements.	NEUTRAL
Write down if they are loose or hard, watery, what color it is, if there is an unusually foul smell, or if you notice any blood.	NEUTRAL
Share this information with your doctor.	NEUTRAL
Talk to a nutritionist to help with planning meals to get your vitamins.	NEUTRAL
Hard thing to do when a person has Crohns.	NEGATIVE
Try to stay regular when it comes to your bowel movements.	NEUTRAL
The more fibrous the food is will because pain and constipation.	NEUTRAL
Try to avoid nuts, fresh fruit and vegetables, whole grains and dairy since lactose intolerance goes hand in hand with Crohns.	NEUTRAL
do not let people convince you to try the latest fads around colon cleansing and probiotics.	NEUTRAL
Always consult your doctor first and I cannot stress this enough do your research.	NEUTRAL
Get your rest.	NEUTRAL
Drink lots of water.	NEUTRAL
Limit anything with caffeine.	NEUTRAL
Join a support group.	NEUTRAL
If there are not any in your area there are several groups on Facebook.	NEUTRAL
Tell them what you deal with.	NEUTRAL
They, like me, will gladly try to help you.	NEUTRAL
we have all been there.	NEUTRAL
We do not want to see others make mistakes if we can help it.	NEUTRAL
Crohns does not have a cure.	NEGATIVE
It can and will come back.	NEUTRAL
The best we can pray for us to be in remission and symptom free.	NEUTRAL
This is a disease you must be mindful of for the rest of your life.	NEUTRAL
Left untreated it will get worse.	NEGATIVE
Take care and good luck.	POSITIVE
If you want to talk to me or ask me questions I am on Facebook as Lori Spurgeon from Ottumwa, Iowa.	NEUTRAL
Just send me a message to remind me it is you so I will make sure to add you on my friends list.	NEUTRAL
The core of the problem is autoimmune, our immune keep atacking our body causes Ulcerative colitis or Crohn.	NEGATIVE
I got UC.	NEUTRAL
Before my immune attacked knees joint, ankylosing spondilitis.	NEGATIVE
I went to doctor but seems helpless because they kept trying to heal my joint.	NEGATIVE
The problem is the auto immune.	NEGATIVE
It happened 10 years ago.	NEUTRAL
Until I found mangosteen skin juice named xamthone (indonesia is my country) it helped a lot to control my immune and my joint healed by itself.	POSITIVE
I back to normal life and skip drinking xamthone mangosteen skin juice.	NEUTRAL
3 months ago I got hemorrhoid and fistula, hurt so bad!	NEGATIVE
I went to doctor and he heal me with 9 injection everyweek to my hemorrhoid and fistula, but he found there are puses in my colon and giving me antibiotics levaquin for 7 days if pus is not gone yet he asked me to do endoscopy.	NEGATIVE
i am so afraid what happened to me since I felt better after my hemorrhoid cure.	NEGATIVE
Then I start search the internet and found that I got ulcerative colitis caused by auto immune.	NEGATIVE
I start to drink that mangosteen juice anymore and feel better.	POSITIVE
Autoimmune causes UC, UC causes hemorrhoid and fistula.	NEUTRAL
Before i. Autoimmune causes joint disease ankilosing spondilitis.	NEUTRAL
So we need to control our immune and mangosteen skin juice help me (God Jesus showed me) I searched a lot and found that cabbage also helped.	POSITIVE
Some aloevera helped too..	POSITIVE
Control the autoimmune first!	NEUTRAL
Go chek the diseases that caused by autoimmune.	NEUTRAL
Hope it helps, Indonesia.	NOT_LABELED
For the past month now, I have had marijuana diarreah.	NEGATIVE
Everything I eat, gives me diarreah.	NEGATIVE
It is extremely painfull.	NEGATIVE
I get cramps that radiate into my legs and down to my feet.	NEGATIVE
I am litterally screaming in pain, in the bathroom.	NEGATIVE
I have had this problem since I was a kid, and it seems to have gotten worse recently.	NEGATIVE
I cannot eat anything without getting bad cramps and diarreah.	NEGATIVE
I have to drink half a bottle of pepto bismol, to keep myself from spending hours in the bathroom.	NEGATIVE
When the Pepto wears off, I will get woken up at 7:30 am, with bad gas and cramping.	NEGATIVE
Then the diarreah will start up again.	NEGATIVE
It will hurt really bad, and then Ill have a movement.	NEGATIVE
Then I feel ok, and then a minute later, the pain and another small movement comes.	NEGATIVE
I now have a dull aching that shows up in my feet, right before the cramps and bowel movements start.	NEGATIVE
The pain gets worse right before I have the movement.	NEGATIVE
I cannot take it anymore!	NEGATIVE
This diarreah is controlling my life and making it very hard to do normal every day things.	NEGATIVE
i am stuck at home sometimes cuz I cannot stop going to the bathroom.	NEGATIVE
The pain is excruciating and nothing seems to make it go away.	NEGATIVE
I take immodiums, but they are expensive and when they wear off, I feel like I wannadie.	NEGATIVE
I have been to doctors for this same problem, minus the foot pain, and they give me the same line of bull.	NEGATIVE
Its stress.	NEGATIVE
Its not stress!	NEGATIVE
I have nothing to be stressed out about!	NEUTRAL
My life is pretty peacefull.	POSITIVE
i am desparate for answers and some kind of relief.	NEGATIVE
i am hoping someone can help me out here.	NEUTRAL
i have tried telling my friends and they tell me i am insane an that it is all in my head.	NEGATIVE
I just wannascream when they say that to me.	NEGATIVE
I feel like i am all alone in this battle and there is no hope of winning it.	NEGATIVE
Please, anyone, if anyone out there knows what is wrong, please tell me!!	NEUTRAL
I have the same problem, though not as extreme.	NEUTRAL
It has been getting worse the older I get.	NEGATIVE
My mom has had the same problems since I can remember, so has my grandpa.	NEGATIVE
If you find out the answer, I would like to know.	NEUTRAL
I have had several tests and they all come back normal.	POSITIVE
I have AS, but I do not think that is a common denominator.	NEUTRAL
Hi from London.	NOT_LABELED
I have similar stomach problems as those that you have described, i am 44 years old and this problem started when I was 11 or 12 years old.	NEGATIVE
i have recently been diagnosed with a condition named BILE SALT MALABSORBTION, Google it and see if it corresponds with your symptoms.	NEUTRAL
do not be fobbed off with useless doctors telling you that it is caused by stress, that does not help you at all does it.	NEGATIVE
Good luck with it, it is not a nice problem to have and there is no real fix for it: - (.	NEGATIVE
I now take large quantities of a powder called COLESTYRAMINE (also know by different names).	NEUTRAL
This powder does sometimes help settle it down, but as I have a particularly bad case of BSM the symptoms never totally disappear.	NEGATIVE
When doctors fail to diagnose an ailment they often ascribe it to ``"stress ,"'' or ``"anxiety.	NEUTRAL
or ``"autoimmune ,"'' a term growing in popularity.	NEUTRAL
I guess it hurts to say, ``"I do not know what is wrong with you.	NEGATIVE
Some of those on this forum may be suffering from a pathogen, in which case the most likely culprit is Candida albicans.	NEUTRAL
There are cases of IBS, Crohns and similar problems in my family.	NEUTRAL
We are having early success by treating one of the sufferers for candidiasis.	POSITIVE
He is taking Lugols solution since fungicides do not work and have serious side effects.	NEGATIVE
I should mention that the proliferation of candida is often caused by sugar and starches, antibiotics, and prednisone and inhaled steroids.	NEUTRAL
Candidiasis is an under-diagnosed ailment.	NEGATIVE
You have PROCTITIS, and Tenesmus which is very painful bowel-movements is a symptom of it.	NEUTRAL
As the time goes by, the Proctitis just gets worse and worse, i.e., the pain during BM is just unbearable to the point that your toes and feet curl just like Bruce Willis did in Diehard........................ ..	NEGATIVE
I had Proctitis for like 12 years and FIXED it with supplements that are Great for the brain which is a Big Bundle of Neurons because I reached the conclusion that I developed Proctitis from some really bad diahrea that I exposed myself to from Chinese food that I consumed for like 15 years.	POSITIVE
The explosive diahrea over the years caused my body to get DEFICIENT in some of those Micronutrients that are CRITICAL for neuronal health like Niacin, Magnesium, vitamin K2, etc...... .	NEUTRAL
The malfunctioning or INJURED nerves because the immune system to attack JUST like it attacks other areas that are injured like a wrist when you sprain it, an infected cut, an insect bite, etc..	NEUTRAL
To FIX those nerves you will need an account at swansonvitamins or any other supplement company to BUY: Tripple Magnesium Complex 400mg/capsule, Balance B-100, Odor controlled garlic 500mg/capsule, Niacinamide 500 mg/capsule, Time-release vitamin c 1000 mg/capsule, vitamin k2, cayenne pepper capsule and any other supplement you feel like you will need like fish oil...... ...	NEUTRAL
These are Great supplements for the brain and nerves, heart, bones, etc.. for example, google: ``"vitamin k2 parkinsons"'' or this one: ``"vitamin k2 pancreatic cancer"'' Start taking vitamin K2 to make sure YOU do not GET CANCER!	NEUTRAL
Protocol for you to fix those nerves: -take 400 mg magnesium daily.	NEUTRAL
take a B-100 capsule with each meal.	NEUTRAL
take 2 of those 500 mg odor controlled garlic capsules with each meal if you can which comes out to some 6 capsules daily.	NEUTRAL
Garlic is very important for fixing this so TAKE as much as you and others around you can tolerate.	NEUTRAL
Garlic is SULFUR and SULFUR IS NEEDED!	NEUTRAL
take at least 4 of those time-release vitamin c 1000 mg capsules daily so that your body can make the collagen that is needed in your skin.	NEUTRAL
You may want to add L-Lysine to your vitamin-c so that your body can make Elastin which is also needed.	NEUTRAL
take 3 vitamin K2 tablets every day and make sure to take a fish pill capsule every time you take a vitamin K2 capsule.	NEUTRAL
You may consider vitamin k1 for this.	NEUTRAL
Vitamin K2 is critical for the myelin covering nerves to be made in your body.	NEUTRAL
take 2 of those 500 mg Niacinamide capsules daily, one in the morning and other in evening after supper.	NEUTRAL
experiment with just ONE cayenne capsule if you buy them but be sure to take it after one of your meals.	NEUTRAL
Your body and nerves there in your colon took years to MALFUNCTION so DO NOT EXPECT RESULTS over night, but I do promise that the Garlic, sulfur, and other micronutrients will fix it IN less than 2 years, and you you will see results within weeks if you take as much of the micro nutrients as posted...... ..	POSITIVE
It took my Proctitis about 2.5 years for me to declare myself healed with absolutely NO SYMPTOM.	POSITIVE
One more note, do you find yourself having cramps in your calf muscle like I did for years????? I bet you do!	NEUTRAL
This is a symptom of Magnesium deficiency!	NEUTRAL
Also every time you go to your doctor your Heart rate is constantly above 90-near tachycardia.........This is also an indication of Magnesium deficiency.	NEUTRAL
go to wikipedia and search: hypomagnesemia then look at the symptoms, and I guarantee YOU WILL SEE THAT YOU ARE DEFICIENT IN JUST THIS ONE NUTRIENT!	NEUTRAL
Niacin deficiency is characterized by 4 Ds.... -Diahrea, dermatitis, dementia, death.	NEUTRAL
B6 and B12 and folate deficiency equals SHRUNKEN BRAIN which means you have lost Millions of Neurons...... ...	NEUTRAL
You are Deficient in B-vitamins, Magnesium, vitamin K2, VITAMIN C because of the daily diahrea!	NEGATIVE
TO fix the Neurons in the colon, you must take a lot of these nutrients to counteract the effect of the diahrea so DO NOT DRINK caffeine or Alcohol during this period because these are diuretics and make you urinate a lot so you urinate the micronutrients out, and YOU ALREADY HAVE A PROBLEM WITH THE DIAHREA DEPLETING your body of them.	NEUTRAL
THE key to fixing these nerves is taking a bunch of those micronrutrients in my previous post JUST DO NOT take more than 400 mg of magnesium, any more than that and it will become a Laxative.	NEUTRAL
To get more magnesium in your depleted body, Use Epsom Salt in your bathtub when you take a bath!!!!!	NEUTRAL
They told me stress at 1st also!	NEUTRAL
Turned out its Crohns Disease but i am still screwed because I was exposed 2TB when I was a Pharmaceutical Tech and the medicines that help Crohns I can't TAKE BC OF THIS EXSPOSER 10+ years AGO IT REALLY ***** knowing what is wrong but still no help from my Gastro doctor!	NEGATIVE
Look into LDN for Crohns...... .Buy a odor controlled garlic 500 mg/capsule from swanson because these will help you.	POSITIVE
taking those garlic tablets is like taking pure SULFUR!!!!! To convince yourself garlic plus all those supplements is what you need go to wikipedia and search ``"Humira"'' and look at the humira molecule to see all that sulfur...... -URL-.	NEUTRAL
allicin is one of molecules in garlic so look at the sulfur in molecule.... -URL-.	NEUTRAL
Try the garlic supplements to see how much they help with the inflammation, but you better add all the other supplements like I posted before you come down with problems like osteoporosis.	NEUTRAL
Your problems could be from a variety of things.	NEUTRAL
I had Achilles tendon surgery about two months ago and develop a weird symptom of having extreme foot pain when I need to have a bowel movement or during the bowel movement.	NEGATIVE
It is a nerve issue.	NEUTRAL
However, I do need to add that I also suffer from Ulcerative colitis (similar to Crohns disease).	NEUTRAL
The pain the legs and feet are from nerves but you need to be checked by a Gastrointestinal doctor for Crohns disease, ulcerative colitis, celiac disease..	NEUTRAL
among others.	NOT_LABELED
Did your pain in your foot with bowel movement go away?	NEUTRAL
I had tarsal tunnel and plantar fasciitis surgery 4 weeks ago and 2 weeks ago, I began to have burning on the ball of the foot with bowel movement.	NEGATIVE
Its pretty painful and the surgeon has no answers and has never heard of this.	NEGATIVE
Please email me with update: *** @ ****	NOT_LABELED
I have had Crohns disease for about 3 years and I am having problems with vomiting and I do not know what to do!!	NEGATIVE
If you have any advice please help, I feel lost!	NEGATIVE
I have some problems swallowing and I frequently feel like there is something in my throat ready to come up.	NEGATIVE
I was vomiting almost every night for about two weeks I then felt a little better and it only occurred every couple of days.	NEGATIVE
Well right now I cannot hold anything down.	NEGATIVE
i am afraid to eat, but I am hungry.	NEGATIVE
I am now starting my days vomiting, sometime in the first couple of hours I wake up.	NEUTRAL
I also started vomiting more than once a day.	NEGATIVE
I went to the dr. last week with my son (monday .) I weighed 149.	NEUTRAL
Today we went back for a medication check for him and I weigh 139 (wed) I tried for a couple of years after the last steroids to lose weight but could not do it.	NEGATIVE
So no its not normal.	NEGATIVE
I have nausea and vomiting and I cannot sleep at night.	NEGATIVE
Any advice............ ..PLEASE HELP!	NEUTRAL
Hi - can only suggest you see a gastro soon and perhaps have an upper endoscopy, and/or small bowel follow through to check for any obstructions which may be causing the vomiting and swallowing problems.	NEUTRAL
What medicines are you on for Crohns?	NEUTRAL
Azathioprine made me vomit and have diarrhea at the same time -	NEGATIVE
I only took it for 2 days and was so ill a doctor had to come to my home - he gave me an anti-nausea shot and advised me to stop the drug immediately.	NEGATIVE
Since then I have been on methotrexate injections weekly and doing fine.	POSITIVE
Sudden weight loss of that order really needs to be addressed quickly, as you will be become malnourished.	NEUTRAL
Take care, Liz in Cornwall, England.	NOT_LABELED
Hi Liz, Thanks for the advice.	NOT_LABELED
I am taking Asacol right now.	NEUTRAL
I took Azathiorine before and your I did not care for it.	NEUTRAL
Please keep in touch, its great talking to people who understand what i am dealing with and who understand crohns.	POSITIVE
The closest support group to me is about 2 hours away And my poor husband and kids have never met anyone other than myself who has had crohns.	NEGATIVE
We are still learning so much.	POSITIVE
Thanks for your advice, its much appreciated!	POSITIVE
Hi there - not sure if I had Asacol, had so many different drugs over the past 38 years, as well as 30+ years of steroids - a no no now, but that was the only drug available to bring a flare into remission in those days.	POSITIVE
IBD drugs have come on in leaps and bounds in recent years, and although I am very stable on methotrexate there are some much newer drugs, anti-TNF biologic therapies, like Humira, Cimzia, Tysabril and Infliximab which gives one hope for the future.I do not know where you live, but believe these drugs are now available in the US but are still being trialed in the UK.	NEUTRAL
My gastro said he has never known anyone tolerate methotrexate for 7 years without serious liver side effects, but guess I have always confounded general medical issues - did not ``"present"'' normally with Crohns - no pain, just severe diarrhea and weight loss, and when I got breast cancer 5 years ago, I had no palpable lump.	NEGATIVE
It was found on a regular 3 yrly mammo, which is all we get here in England with our socialized health service.	NEUTRAL
If I had known what I know now, I would have had private mammos in the intervening years, and perhaps the cancer would not have spread to my lymph nodes.	NEGATIVE
Being a glass half full person, I try and find something positive in each and every day now, rather than dwelling on the past, or what may happen in the future.	POSITIVE
I do my research, am able to talk articulately to my doctors, and just so pleased to be alive, even with a somewhat curtailed lifestyle.	POSITIVE
Hope you get some relief soon for your symptoms - if I can help in any further way, just let me know.	POSITIVE
Take care, Liz.	NOT_LABELED
Hi again, just had a thought that may help you.	POSITIVE
When I was on FEC chemotherapy for breast cancer, I was very sick (vomiting and diarrhea) and could not even eat a mouthful of home made vegetable soup with the solids strained out without rushing to the loo.	NEGATIVE
My Oncologist prescribed a small daily dose of dexamethasone (a steroid) and got the hospital to send me a huge carton of Fortijuice - a vitamin and mineral juice type drink - 9 different flavors, all yucky, but I had to have some nourishment to stay alive.	NEUTRAL
Each carton had 300 cals and I had to sip 3 cartons a day.	NEUTRAL
Did the trick!	NOT_LABELED
I also had bad nausea, and found that any drink with ginger in it did quell it somewhat.	POSITIVE
I seemed to have drunk gallons of non alcoholic ginger beer (cloudy and fizzy) and ginger ale (clear and fizzy), plus the occasional treat of Stones Green Ginger wine - slightly alcoholic, topped up with ice and ginger ale.	NEUTRAL
These drinks stopped me from becoming dehydrated.	POSITIVE
I did lose some 28 lbs during the 4 months of FEC chemotherapy, but have put it back on thankfully and am steady at 112 lbs.	POSITIVE
perfect for my small frame and height.	POSITIVE
Just a thought - many of my because sisters have also found ginger very helpful in dealing with constant nausea.	POSITIVE
Li.	NOT_LABELED
Liz, Thank you so much.	NOT_LABELED
Your comments prompted me to get myself to the doctor.	NEUTRAL
I feel so much better.	POSITIVE
I am able to eat (with limitations) but I am holding my food down.	POSITIVE
I have not had any vomiting and very little nausea.	POSITIVE
I am still have a lot of joint pain and I need to go see the doctor again regarding: that symptom.	NEGATIVE
Do you suggest any medicines with little side effects.	NEUTRAL
The doctor gave me percocet for the pain but that is not working so well.	NEGATIVE
I did not want to go the standard route of steroids to cure the flair up and thankfully the doctor is treating my symptoms individually.	POSITIVE
I hope you are doing well, i am so happy to have found a crohns friends with the same ``"happy to be alive"'' feeling that I have.	POSITIVE
I feel good on this forum being able to talk about my disease without feeling like i am complaining.	POSITIVE
My husband says I never tell him when i am not feeling well.	NEGATIVE
But i am so happy to be on this earth with my children that I do not like to complain about my crohns.	POSITIVE
thanks for all the advice.	POSITIVE
Hi - good to hear you are feeling a tad better and eating a little.	POSITIVE
Not sure which medicines you want advice on - I take, on rising, one codeine phosphate (helps with the lower abdomen pain), one imodium, to slow down the motility, one folic acid (necessary when taking methotrexate) and inject myself with 12.5mg of methotrexate weekly.	NEUTRAL
( I take other medicines for breast cancer and osteopenia).	NEUTRAL
Mtx can be very toxic to the liver especially, but I have monthly blood tests and am tolerating it well.	POSITIVE
I do not feel I have side effects at all from mtx, but have had to stop my because medication, Arimidex, which has caused severe joint pains (hips, hands & feet).	NEGATIVE
Stopped 4 weeks ago and the pain has diminished somewhat.	POSITIVE
Seeing GP 28th May for referral to a new Oncologist as mine retired last year.	NEUTRAL
You are right to steer clear of steroids.	POSITIVE
When I was diagnosis in 1970, the dark ages as far as Crohns was concerned, the only medication to bring a flare into remission was prednisone, and the thinking then was it would keep one in remission, which has now been proven to be inaccurate.	NEGATIVE
I was on steroids, varying amounts, for 30 years and this has played havoc with my bone density, which is classed osteopenic after various DEXA scans.	NEGATIVE
I take alendronic acid (a bisphosphonate) weekly, and daily Calcichew/Vit.D to strengthen my bones and prevent further loss.	NEUTRAL
Nobody told me all those years ago that steroids did this, perhaps they did not know, but even if they had, there was no alternative to steroids.	NEGATIVE
Happily, there are so many new drugs now for Crohns, it seems to be a question of trial and error to find one that keeps you in remission.	POSITIVE
Guess I discovered the holy grail when I found mtx on the internet and badgered my then gastro to prescribe it off license.	POSITIVE
It is still not licensed in England for Crohns as the mfrs feel there are too few patients to make the licensing costs worthwhile.	NEGATIVE
Are you on an immuno-suppressant?	NEUTRAL
I remember some years ago when the Crohns & Colitis Foundation of America (CCFA) had a website where questions were answered foc by a retired gastroenterologist, Dr. Eugene May.	NEUTRAL
That forum is now defunct, due to legal problems, diagnosing/prescribing over the net.	NEUTRAL
However, Dr. May did say that Crohns patients should always be on an immuno-suppressant (like mtx), because the disease is incurable.	NEGATIVE
I have not had a flare since taking mtx, except for a bad one when having FEC chemotherapy for breast cancer and had to stop the mtx.	POSITIVE
Take care Li - always happy to share my own experiences with you if I can help at all.	POSITIVE
Liz.	NOT_LABELED
Hi Liz, Hope you had a great weekend.	POSITIVE
i am in the same boat!!	NEUTRAL
I wake up vomiting and can't hold anything down.... When its that sever it lasts about 2 weeks and then Ill go down to 2-3 times a week.	NEGATIVE
Even if i just have some water in the morning I might vomit.	NEGATIVE
i am currently on pentasa, and going to start predisone in July.	NEUTRAL
i am VERY nervous.	NEGATIVE
I rather vomit then go threw all the side effects i have heard of!!!	NEGATIVE
But vomiting is affecting my daily life.	NEGATIVE
I think its been about 5 days since I last threw up and that is the longest of gone since probably November.	NEUTRAL
Now its coming out the other end (I think is worse) i am going any where from 4-10 times a day and its not nice!	NEGATIVE
So I do not think there is much you can do.	NEGATIVE
Its just living with crohns!!	NEGATIVE
i have tried changing how I eat and even that has not made a difference.	NEGATIVE
If you find anything that helps please let me know!!	NEUTRAL
The Dr. gave me compazine for the vomiting.	NEUTRAL
I helped but I had to stop taking it because it made my joints hurt too much.	NEGATIVE
How are you doing on the prednisone?	NEUTRAL
I am a former patient of doctor may and I have a question I need to ask him is he still available?	NEUTRAL
i have had Crohns for 18 years, and i have had my share of medicines.	NEUTRAL
Prednizone, Sulfasalazine (Azulfidine), and more recently ENTOCORT EC (a nonsystemic corticosteroid) - basically works like a steroid without going into the bloodstream, so it has very limited side effects.	NEUTRAL
My Crohns has always been upper track, especially in the stomach.	NEUTRAL
If my stomach is upset with stress, booze, or too much acid I get horrible stomach pains and usually vomit and do not eat for several days.	NEGATIVE
My health insurace decided to stop covering my medicine for heart burn, Protonix, they want me to use over the counter digestive band aides.	NEGATIVE
This stresses me out, so I get sick.	NEGATIVE
I also manage my Crohns with Canabis.	NEUTRAL
When I first started smoking, my major symptom-appetite loss all but disappeared.	POSITIVE
Then I was able to start looking at other supplements and how to treat Crohns with better eating.	POSITIVE
No more red meat, especially red meat that is fed with corn- this means no fast food, no mystery meat!	NEUTRAL
I had an almost immediate health turn around after making this change.	POSITIVE
No more corn!	NEUTRAL
Especially processed corn, it destroys your insides by throwing off the natural fatty acid balance.	NEGATIVE
Supplement with fish oil to help with this.	POSITIVE
When your doctor prescribes antibiotics, make sure to take Probiotics to increase healthy micro-flora.	NEUTRAL
Find out where you need nutrients and supplement wisely.	NEUTRAL
Exercise exercise exercise!	NEUTRAL
Seek counseling and find others who have the same troubles and talk about it.	NEUTRAL
Better to get it out than hold in in your stomach!	NEUTRAL
Be well.	NOT_LABELED
I am a 25 year old female.	NEUTRAL
I was diagnosed with Ulcerative Colitis almost a year ago after having a bad attack after pizza one weekend that never went away.	NEGATIVE
It took about 3 months of extreme pain, biopsys, barium tests, and a colonoscopy to find out what I was sick with.	NEGATIVE
I spent 3 months off of work resting at home because I became so sick and malnourishment and too many trips to the bathroom to count.	NEGATIVE
The pain I experienced was horrible.	NEGATIVE
I would get bundled over with abdomal pain and just start crying in front of my customers due to the insane pain.	NEGATIVE
I was put on my first treatment of ENTOCORT EC for 4 months along with Protonix for the heartburn, and another pill for the nausea.	NEUTRAL
I was able to return to work after 3 months but was still feeling very ill.	NEUTRAL
Its been almost a year and I am not healing as suspected so I am on my second round of treatment with Entocort and protonix.	NEUTRAL
I am struggling to find out what my body can eat and what it can't.	NEUTRAL
I am still throwing up a few days in a row in the mornings no matter what it is that I eat and It seems that when I start to feel ill it last about a week.	NEGATIVE
Everyday is a different story and that is frustrating in itself.	NEGATIVE
This has taken a toll on my normal cheery self and the steroids give me horrible side effects including: depression, insomnia, weight gain, sweats, nausea, etc.	NEGATIVE
The depression is the worst, I feel very angry that at 24 years old I have been handed this card and I am not able to live the life of a normal 25 year old right now.	NEGATIVE
Its going to take some time to get use to the idea but I believe everything happens for a reason and we are not given more than we can handle...most of the time.	NEUTRAL
I wish the best of luck to everyone and Its not an easy journey but you are a stronger person for doing it.	POSITIVE
Begin by only eating brown rice and soy yogurt.	NEUTRAL
Make a record of food that make you sick.	NEUTRAL
Basil and many spice made me sick.	NEGATIVE
People think I am crazy but it works.	NEGATIVE
Hi, my boyfriend got diagnosed with Crohns disease last year and has been hospitalized around 6 times.	NEUTRAL
He has been on a few different medications and all seem to do NOTHING.	NEGATIVE
He has now been throwing for the last 2 days, trying to only eat what the Dr. told him (soup broth, ginger ale & crackers).	NEGATIVE
The interesting thing is he is not throwing up any food, its all acid & the last 2 days its been just about every 2 hours.	NEGATIVE
he's taking 6mp right now & refuses to take the nausea medicines because it gives him a horrible migraine.	NEGATIVE
Is there something the Dr. is missing, not giving him, or any other medications out there that work better in these cases?	NEUTRAL
If so I would greatly appreciate some advice.	POSITIVE
Thank You!	NOT_LABELED
Hi All, I thought I would let some people know what my experiences were.	NEUTRAL
I have Ulcerative colitis, and really from the start (3 - 4 years) i have had constant morning nausea.	NEUTRAL
To be 100% honest, I get nausea and dry reaching / vommiting, but it is almost always when I get up, and before I eat, normally in the shower i have 5 - 10 minutes of dry reaching.	NEGATIVE
It is not effected by bowel movements, i.e I have not gone to the toilet or even after I still get it.	NEUTRAL
I changed my medicines from salfa to mesaline and that made a 10% difference, certainly not signifant but enough to offer a little relief.	POSITIVE
I have not found a solution to preventing something like this, and again being honest its something that I have almost gotten used to, its not something that I like to have to go through every morning, nor is it nice for my partner to listen to, but I certainly am getting used to it, and not eating before makes it a little easier, if i was to have breakfast then be sick, i would not be able to handle it, so I normally do not eat breakfast.	NEUTRAL
Sorry its not a solution, rather another perspective.	NEUTRAL
Just wondering if ant fellow crohnies out there have had kidney trouble.	NEUTRAL
Like stones, marijuana uti - bladder-kidney infections, urinating up to 20 times aday everyday?	NEUTRAL
if anyone has information or exprience please let me know.	NEUTRAL
Thanks, Pro2675.	NOT_LABELED
Hello!	NOT_LABELED
Have any of you, who have problems with vomiting, tried this.	NEUTRAL
-URL-Magnesium is not well absorbed if small intestine is affected, and deficiency can because many problems.	NEUTRAL
Magnesium can be absorbed trough skin and this may help.	POSITIVE
i am having problems with absorbtion (just muscle spasms so far) Just to add - i am at the beginning of road to Chrons (35 years, male).	NEGATIVE
Scared to death, because It is in my small intestine.	NEGATIVE
So far I have just had two nights of stomach pains.	NEGATIVE
No medicines at this time, doctors think i am just another nut patient.	NEGATIVE
Sometimes just wish to die, frustrated to the end.	NEGATIVE
Sorry for my english, I come from Europe.	NEUTRAL
God bless you all!	NOT_LABELED
Primus75.	NOT_LABELED
I was dignosed with Crohns over the Christmas holiday 2011 after spending the night in the emergency room, with what I thought was a violent case of the stomach flu.	NEGATIVE
I do not have medical insurance therefore have not been to my Primary Care Dr. for any follow up.	NEGATIVE
I seem to get sick to my stomach ALL the time.	NEGATIVE
I could be riding in the car and all of a sudden I have to throw up.	NEGATIVE
i am not one for taking ``"Modern or Western medications"'' would love to treat this as homeopathically as possible.	NEUTRAL
I go from feeling great to feeling like a have the flu in a matter of minutes sometimes.	NEGATIVE
My husband just thinks i have turned into a complainer and has little to no sympathy, which is emotionally rough.	NEGATIVE
Any thoughts or words of wisdom from any Crohns Vetrans?	NEUTRAL
Heide.	NOT_LABELED
hi, my daughter has the same thin vomoting acid, she is on sulfolk anti inflamitrys and that is all	NEGATIVE
she was doing well on probiotics, everymorning, vitaminc with glutamine, and then red paw paw, mist a couple weeks while she was in london and has now bin sick 4 over a month.	NEGATIVE
in the last week and a half she has bin vomiting everytime she eats a little, but its like acid, water, bin to doctors, nothing else has bin given, i am a bit worried she has lost 4 kilo in three days.	NEGATIVE
red paw paw is one food that is staying down.	POSITIVE
also gingerbeer mkes her feel better.	POSITIVE
i do not agree with sterriods either, but would use for 3 days in an emergency, if i felt her bowls where gonna na burst.	NEUTRAL
this is something new for us, the vomoting thing, if anyone has any ideas would be great, she was only diagnosed 4 months ago.	NEUTRAL
x jade.	NOT_LABELED
Buy aloe vera juice, drink it before bed.	NEUTRAL
Not the sugary drink but the stuff at the health food store.	NEUTRAL
Cut out wheat from your diet....it inflames.	NEUTRAL
Corn is also iffy.	NEGATIVE
Grains are hard on the system.	NEGATIVE
Ask your doctors to put you on the steroid treatment and good luck.	NEUTRAL
Buy aloe vera juice, drink it before bed.	NEUTRAL
Not the sugary drink but the stuff at the health food store.	NEUTRAL
Cut out wheat from your diet....it inflames.	NEUTRAL
Corn is also iffy.	NEGATIVE
Grains are hard on the system.	NEGATIVE
Ask your doctors to put you on the steroid treatment and good luck.	NEUTRAL
Google wheat and how horrible it is on the body.	NEGATIVE
Go glutten free and cut grains as low as possible.	NEUTRAL
I agree with there cannibis!	POSITIVE
Its the ONLY thing that helps me!	POSITIVE
Also yogurt and rice.	POSITIVE
I have been on Orednisone at high doses, for 30 years as I sit here, with 8 fractured vertebrae and 2 fractured Prlbis, I am MOW wondering if it was worth it!	NEGATIVE
HOWEVER my Rheumy has dropped my Prednisone from 80 mg/ day, to 7 1/2/ day, and I feel HORRID!	NEGATIVE
I, too, started vomiting a lot!!!	NEGATIVE
As this is my LEAST favorite exercise, I begged the emergency room doctor, the other day, for something for it- he gave me some sublingual Xofran tablets!	NEUTRAL
What a MIRA CLE!!!	POSITIVE
I also take Lomotil, daily, and at times must need it up with Imodium.	NEUTRAL
Multi Symptom tablets.	NEUTRAL
He also have me a TRUE wonder drug, called, Hydroscyamine- which stops the gramps, even before it is through dissolving!	POSITIVE
I take Entocort, too, and it helps the intestines tremendously, but it is cost prohibitive, at $1,700.00/ month!!	NEGATIVE
I also take Lialda, an anti inflammatory that act just in the gut! Love it!	NEUTRAL
Even with all of these tools, I am having to wear a Depends , 25/8!!!	NEGATIVE
i am only 55, and have not found anyone yet!	NEGATIVE
Not going to, this way, either!!!	NEUTRAL
laughing out loud!	NOT_LABELED
I, too, vomit watery bile- which I hate!!!	NEGATIVE
The Zofran has helped that, my other problem, though, is that my Medicare ins . Only covers 6 prescriptions/ month!!	NEGATIVE
I now take 38!!!!	NEUTRAL
Am totally disabled, and cannot afford that much to spend just on scripts- every month!!!	NEGATIVE
I had my colon removed in 2004 because of severe ulcerative colitis.	NEGATIVE
My surgeon was able to perform a Restorative Proctocolectomy, so I have an internal J-Pouch.	NEUTRAL
Life with the J-Pouch has been tons better than with the rogue colon, but it has never been 100 %.	POSITIVE
My doctor and I have tried all kinds of medications to get it to calm down, Flagyl, Amitriptylin, Glycopyrrolate, Xiflaxin.	NEUTRAL
The only thing that has seemed to help was Ciprofloxacn, which then stopped working after a time and now works again in combination with Tindamax.	POSITIVE
My surgeon would prefer me not to be continuously on two antibiotics and I would certainly prefer that too, but the alternative is not fun, cramping, constant bathroom visits and the worst is leakage at night.	NEGATIVE
Does ANYONE have any remedies, natural therapies, a different medication to suggest, really anything?	NEUTRAL
I have also tried a course of probiotics while not taking medication and my pouch just continued to get worse.	NEGATIVE
Have they looked at your diet?	NEUTRAL
You may be eating too much fiber, sugar and/or spices.	NEGATIVE
i have had my pouch for 15 years and definitely the first year or so was tough but I eventually got into the habit of eating bulking foods (oatmeal, marshmallows, apple sauce, meats, eggs) and avoided heavy fiber foods and spices.	NEUTRAL
Eventually i have been able to eat anything but occasionally if I have too much spicy or too much salads or sugar I run into problems.	NEGATIVE
I assume you take an anti-diarrheal?	NEUTRAL
Thank you for your response.	POSITIVE
Unfortunately, even when I had Ulcerative Colitis, diet never seemed to make a difference.	NEGATIVE
However, I do avoid spicy foods because they do bring pain.	NEGATIVE
As far as anti-diarrheals, I have tried Imodium, but it seemed to make me feel like I had a blockage or constipation, but maybe I was taking too many or something.	NEGATIVE
Thank you for the thoughts; Id definitely appreciate any more you might have.	POSITIVE
There are some other prescription drugs your doctor can give you - antispasmodics.	NEUTRAL
Do ask for those.	NEUTRAL
They can make a big difference.	POSITIVE
has anyone ever gone back to illeostomy after having on going problems with j- pouch?	NEUTRAL
need advice, i am thinking about removing j pouch ,	NEUTRAL
never get enough sleep, ,up 5-8 times a night, ,always looking for bathrooms, anal area always sore, ,on going hemroids, occassional fistuals, on antibiotics ,	NEGATIVE
just wondering if life is any better with out j pouch, ,looking for answers, ,, please someone HELP.	NEUTRAL
Thanks cka58.	NOT_LABELED
I have UC and i have had a j-pouch for 6 years now..	NEUTRAL
And have had nothing but problems.	NEGATIVE
I had pouchitis which you talked about and have been put on the same antibiotics for years at a time and nothings worked.	NEGATIVE
My doctor is now going to try the drug 6mp because I have fistulas and ulcers.	NEGATIVE
He said if that does not work the drug called Remicade would be his 2nd option.	NEUTRAL
Maybe you should ask your doctor about those two drugs as well.	NEUTRAL
Cka58 I feel your pain its like a never ending battle with UC.	NEUTRAL
Trudie that is strange you mentioned you felt like you had a blockage after taking Imodium.	NEUTRAL
because after my surgery maybe 6 months after they started me on that and I ended up getting a blockage which they had to go in and correct.	NEGATIVE
I always thought it was from that drug as well.	NEGATIVE
If you want to slow down your bathroom visits i would say take metamucil.	NEUTRAL
Hope everything works out for the best ...	POSITIVE
I have marijuana Pouchitis.	NEUTRAL
I have had the pouch for 10 years now.	NEUTRAL
I have tried everything from diets to anit-diarrhea medicines, anitbiotics and remicade.	NEUTRAL
Nothing has yet worked for me.	NEGATIVE
Have had the bag option in mind, but trying to hold off as long as possible.	NEUTRAL
i am only 28.	NEUTRAL
I will be going over a reconstructive surgery for a possible new pouch.	NEUTRAL
I am up every 2 hours throughout the night and need to plan my day around the bathroom.	NEGATIVE
I am an athlete and this is probably the worst hold back ever.	NEGATIVE
Any thoughts??	NOT_LABELED
I had what I thought was marijuana pouchitis.	NEUTRAL
The medicines were not helping.	NEGATIVE
I found that I had an overgrowth of yeast in my body.	NEUTRAL
Went on a few weeks diet of no yeast, gluten, sugar and added probiotics and took a supplement from a naturopath which killed the yeast and then went back to a normal diet.	NEUTRAL
Talk to your doctor about xifaxan.	NEUTRAL
Its an antibiotic that only impacts the digestive tract.	NEUTRAL
i have had marijuana pouchitis since getting my pouch 11 years ago, and this is the only thing that helps.	NEUTRAL
I also take a small amount of probiotic in the form of yogurt every day.	NEUTRAL
that is counterintuitive with the antibiotic, but they seem to strike a better balance that with the antibiotic alone.	POSITIVE
I have had j-pouch since 1991 and last few years have had very bad pouchitis overflow incontinence.	NEGATIVE
Pouch nurse gave me a Medina cathater which is a tube with which you can empty the pouch.	NEUTRAL
I carry it with me all the time and has helps me keep the pouch empty.	POSITIVE
I have also started on a no sugar, no milk, no wheat diet plus daily use of VSL3 probiotic.	NEUTRAL
Seems to be helping, especially the Medina cathater which stops (not completely but 80 %) the incontinence.	POSITIVE
I recommend it.	POSITIVE
Hi, my name is Serina.	NEUTRAL
I am 19 years old and I have a j-pouch too.	NEUTRAL
I have had mine for about a year, and i have pouchitus.	NEUTRAL
I am on humira, which helped at first but eventually stopped working.	NEGATIVE
I went to see a nutritionalist who works with people who have chrones, bid, and uc.	NEUTRAL
She has me on a diet that eliminates ALL grains.	NEUTRAL
I eat a lot of cooked vegetables, protein from fish and chicken, and this wonderful bread called ``"almond bread"''.	NEUTRAL
You make it from ``"almond meal"'' that you can find at trader joes.	NEUTRAL
It is pretty much just pure almonds and eggs.	NEUTRAL
It is amazing and never hurts my stomach!	POSITIVE
I strongly suggest you make some.	POSITIVE
Just type in ``"almond bread recipe"'' in google.	NEUTRAL
Also probiotics, aloe Vera capsules, and a multivitamin are good.	POSITIVE
If you can afford it, go to some yoga classes, get some reiki, and do some meditation.	NEUTRAL
Hope this helps!	NEUTRAL
i have had my pouch for over 15 years . i have had nothing but problems with it.	NEGATIVE
we have tried all the above.	NEUTRAL
Still have pouchitis every day & worse.	NEGATIVE
I have not had a nights rest in all that time.	NEGATIVE
i have simply come to terms with it.	NEUTRAL
For better or worse this is me.	NEUTRAL
I try to think of all the things I would have missed altogether without it.	NEUTRAL
I am a 51 year old female who had UC most of my life.	NEUTRAL
In 2007 I had a total protoctomay w/J-pouch and my life could not be any worst.	NEGATIVE
I have nothing but complications especially with pain.	NEGATIVE
I have severe pain and spasms in my anal and pouch area that if not treated i am sure I would die from heart failure because this pain is absolutely intolerable.	NEGATIVE
I have been on high doses of morphine since the day of my surgery.	NEUTRAL
I take 15mg of morphine every 8 hours plus breakthrough throughout the day as needed.	NEUTRAL
I have pouchitis all the time and now my pouch is ulcerated.	NEGATIVE
I have incontinence through out the night.	NEGATIVE
Go to the bathroom at least 7-8 times a day.	NEGATIVE
I use to be a runner but now can have no physical activity because of my incontinence and frequent bathroom stops.	NEGATIVE
If I do anything physical or lift anything heavy I through myself into spasm which then require more morphine to manage my pain.	NEGATIVE
i am tired, depressed and scared to think this is my life.	NEGATIVE
I have been seeing Dr. Bo Shen of the Cleveland Clinic who gives me alcohol and kenelog injections into the cuff of my J-pouch evert 6-months and at first this seemed to help with some of my pain and I was able to decrease my morphine intake.	POSITIVE
However, lately I feel little relief.	NEGATIVE
I have not heard anyone talk about pain.	NEUTRAL
Really need some advice and encouragement.	NEUTRAL
BG.	NOT_LABELED
I had a brooke ileostomy before I got my ``"K"'' pouch and I wish I never made the change.	NEGATIVE
i have had pouchitis over and over and it really wears you down.	NEGATIVE
For me the ileostomy was not a huge issue but the wife was not too happy.	NEGATIVE
Sadly the wife is now my ex and I live with this pouchitis everyday.	NEGATIVE
Hope to make the change back and eat whatever I want and no longer have to deal with the pain.	NEUTRAL
This procedure is not well known but is excellent.	POSITIVE
Go to -URL- and check it out if you are tired of your J-pouch not working correctly or still having to search for bathrooms every hour or so.	NEUTRAL
Or if you tired of dealing with your Brooke Illeostomy not staying on or damaging your skin.	NEUTRAL
I have had UC for 15 years and finally all of the medicines stopped working.	NEGATIVE
When my Gastro told me that I needed to have my colon out I was devastated.	NEGATIVE
I had researched the ``"bag"'' and was not pleased with the results.	NEGATIVE
I also was not excited about the J-pouch option as it did not seem to improve the quality of life much and so I looked further into the BCIR option.	NEUTRAL
I had a total proctocolectomy on 3/21/14 and life is getting better.	POSITIVE
The BCIR is similar to a Koch pouch with an improved valve design so there is no incontinence/leakage.	POSITIVE
I wish more Doctors knew about this option to at least give us, their patients more choices.	NEUTRAL
Dr. Ernest Rehnke from the Palms of Pasadena Hospital in St. Petersburg, Florida is an extremely talented surgeon and the staff at the Palms is fantastic.	POSITIVE
Please at least check into this option and make an informed decision.	NEUTRAL
i am glad I did.	POSITIVE
The only thing that works for me are a good Pro-biotic pill.	POSITIVE
and drink Dan Active, one Dan Active morning & bedtime.	POSITIVE
Avoid greasy foods!	NEUTRAL
Drink lots of water.	NEUTRAL
Red meats are hard to digest so tend to because a blockage.	NEUTRAL
Baked chicken, fish, & turkey are okay.	POSITIVE
Avoid too many sweets & may sound silly, but chew your food well before swallowing.	NEUTRAL
I am a 32 yera ld female with crohns.	NEUTRAL
within the last week I have had extreme joint pain and inflamation.	NEGATIVE
in my hAnds.	NEUTRAL
My knees hurt and I have lost all feeling in my left middle finger.	NEGATIVE
When I sleep, or try to sleep, both of my arms and hands go numb.	NEGATIVE
I got blood work and my ana count is high.	NEUTRAL
They want me to see a reuhmatoid doctor, I am wondering if this is not crohns related, ,, any help for a sister would be appreciated.	NEUTRAL
Definitely Chrohns related.	NEUTRAL
i am 38 and most days my knees feel like they are 102.	NEGATIVE
My gastrointestinal also wants me to see Reuhmatiod specialist.	NEUTRAL
i am reluctant because it means more doctors, and more medicines.	NEGATIVE
I already have to get up an hour early to take all my morning meds.LOL.	NEGATIVE
What a yummy breakfast!	NEGATIVE
I have seen that a few people take Aleve to help with this.	NEUTRAL
My gastrointestinal claim that is the worse thing to take with Crohns.	NEGATIVE
I was taking it and getting some relief, until he said that.	POSITIVE
hey i understand your pain, i have crohns as well and i have been dealing with arthritis on hands and feet and my ring finger on both hands go numb every day along with pain that radiates to my elbow.	NEGATIVE
i have to take pain killers to feel better and able to work, so do not feel alone i am there with you.	POSITIVE
hang in there!!!!!!!! kathy.	POSITIVE
I also have crohns and I hear you.	NEUTRAL
I have such pain in knees, hands, neck and especially my lower back.	NEGATIVE
Only take tylenol as recommended by gastro doctor.	NEUTRAL
Advil causes bleeding, etc . ladybea.	NEGATIVE
I was diagnosed with Chrons in 11/07.	NEUTRAL
The only reason I am at this point is that in June 07 I began having wicked arthritis in my entire body.	NEGATIVE
I could barely move, pick things up, etc.	NEGATIVE
After many doctor visits, appointments with numerous specialists (including an RA specialist, after taking many ugly medicines with bad side effects) I was sent to a gastrointestinal and diagnosed with Chrons Colitis.	NEUTRAL
He said that the arthritis is a direct side effect of the Chrons.	NEUTRAL
I only got my life back after a crazy regimine of steroids and Celebrex.	NEGATIVE
Now I am being weened off of the steroids (it is painful and the arthritis flares up every now and then) and am on Imuran and am bouncing back.	POSITIVE
Unfortutanely I still have to deal with the issues with the damage I sustained when my immune system decided to attack all my joints.	NEGATIVE
I feel for you all, and it seems mostly ladies?	NEUTRAL
I have had Crohns for over 25 years and have had three resections in 1984 , 2001 & 2007	NEUTRAL
I have been on various drugs over the years and had good and bad years.	NEUTRAL
For around a year now I have been on infleximab by infusion, Methotrexate tablets as well as taking Questran to help digestion, folic acid and 3 monthly B12 injections.	NEUTRAL
I have had some trouble over the years with stiff joints in my hands, mostly in winter, but around four months ago I started getting real pain in my hands and fingers followed by them swelling, this then started in my feet and ankles, legs, knees, arms elbows and shoulders and seems to move from one place to the other on a 2-3 day basis, it sometimes even changes from being severe to the point of not being able to use my hands to just a slight pain and completely moved to, say a knee or a foot over night.	NEGATIVE
My only respite now is too many pain killers and complete rest, as soon as I work (I do not to anything too manual these days) or take exersize one or another, or several of my limbs will be extremely painfull or sore to touch very soon after.	NEGATIVE
The pain is not confined to my joints, in fact there is not always pain in the joint, more around it and in cases up my arm or leg, more like, and it changes, tendon or muscle pain.	NEGATIVE
Yesterday my ankle was swollen and painfull to move, enough to because me to limp and my calf muscle felt as though I had a severe cramp in it every time I put my foot to the floor.	NEGATIVE
The strangest thing is this continuing changing of the area that gives most pain.	NEUTRAL
I am coming to the end of my tether with this, my Doctors keep telling me its to do with the Crohns, we will have to do more tests etc.etc.	NEGATIVE
My Crohns has been very good as far as I am concerned for some time now, although I have recently had a pillcam which seems to reveal that the Crohns is active but there is nowhere to go medically, looking like the only option is more surgery.	NEUTRAL
If the surgery would get rid of the new symptoms while the Crohns stays at bay, great but I am now 54 and not keen on yet more surgery when I feel in myself that this is a separate issue from the Crohns.	NEGATIVE
There are apparently more than 70 kinds of arthuritis, is it possible that this has nothing to do with the Crohns and should be investigated on its own symptoms?	NEUTRAL
I find if you have Crohns any other ailment at all is lumped in with it, ``"Oh that is to do with your Crohns"'' is sometimes a very convenient answer.	NEUTRAL
Any help at all would be appreciated, if any one else experienced anything like this or any proffesionals out there have heard of similar symptoms please get in touch through this site or direct to *** @ **** Thanks.	NEUTRAL
Wow!	NOT_LABELED
Its nice to hear that I am not really crazy.	POSITIVE
I was diagnosed with Ulcerative Colits and Relapsing Polychondritis in 2009 and i have had so many side issues I do not know which is to blame.	NEUTRAL
Its very difficult trying to work or even explain to some people what is going on with my body.	NEGATIVE
Some days I wake up and everything is just fine and some days i am drained because I may have spent half the night in the bathroom or I wake up to some part of my body being swollen.	NEGATIVE
Sometimes it is the joints but more often than not it is the area around the joints (from the RP).	NEUTRAL
In the last year i have had swelling/inflammations in my nose, ear, face, neck, elbow, wrists, arm, fingers and toes.	NEGATIVE
One day both of my ankles were totally swollen and I was confined to bed which is very difficult with UC.	NEGATIVE
Its become a running joke each day to see what part of my body is sore or inflamed as i am trying to see the humor in all of this to keep from crying.	NEGATIVE
Anyway, just wanted to say it is actually good to know that i am really not alone in this craziness.	POSITIVE
Thanks for sharing everyone ...	POSITIVE
I was diagnosed with Crohns in 1996.	NEUTRAL
Resection, steroids, remicade, humira all have helped with the digestive symptoms, but two years ago started having the SAME symptoms as nace1.	NEUTRAL
I am at my with is end with this joint/muscle pain/stiffness/swelling.	NEGATIVE
I feel like i am 100 years old.	NEGATIVE
I had some relief with the Humira, but have been hospitalized TWICE with pneumonia in the last six months and was told.	NEGATIVE
I have to go off all the immunosuppressant drugs and am praying the digestive symptoms will not return.	NEUTRAL
In the meantime I am turning into a Vicodin junkie, as it is the only thing that remotely takes the edge off the pain.	POSITIVE
Thanks for letting me vent, and if anyone has any suggestions, I AM WILLING TO TRY ANYTHING AT THIS POINT.	POSITIVE
Blessings to all ...	NOT_LABELED
I have had Colitis for 27 years.	NEUTRAL
The flare ups for 10 years were minimal..	POSITIVE
Sulfasalazine was the medicine of choice back then.	NEUTRAL
Early 90s a flare sent me to the gastrointestinal.	NEGATIVE
He changed medication to Dipentum.	NEUTRAL
Shortly after that I started aching inn my right elbow.	NEGATIVE
It would come and go.	NEUTRAL
This went on for 10 years.	NEUTRAL
I did a lot of jogging.	NEUTRAL
Seemed like the farther jogged my aches grew.	NEGATIVE
Then the aches went to my shoulders.	NEUTRAL
Sometimes my hips.	NEUTRAL
The last flare started 2 years ago, and has just now getting under control.	POSITIVE
I tried Remicade, it seemed to be a wonder drug, for a month.	POSITIVE
It slowly became useless.	NEGATIVE
I tried Humiria, it seemed to work fair.	POSITIVE
Finally I went back to Colazal.	NEUTRAL
Taking 3 pills 3 times a day.	NEUTRAL
Plus I am on Entocort.	NEUTRAL
I am slowly getting better.	POSITIVE
My ``"urgency"'' to go it all but gone now.	NEUTRAL
But during my 2 year flare, My joints did not hurt!	POSITIVE
Now that the flare is under control, I am starting to hurt again.	NEGATIVE
I tried jogging 3 weeks ago and that really got my shoulders and elbows hurting.	NEGATIVE
Apparently from the bouncing motion.	NEUTRAL
Anyway It seems that there is an infection in me that is either in my colon or in my joints but not at the same time!	NEUTRAL
I do not like taking Tylenol all the time.	NEGATIVE
I take a half of a Lorcet when it really hurts.	NEUTRAL
Anyway I just wanted to post ``"my"'' situation for anyone else who may have similar problems.	NEUTRAL
Hopefully ``"if it does not kill us, it will make us stronger"''.	POSITIVE
And please, anyone else reading these posts, do the rest of us a favor and post your ``"problems"''.	NEUTRAL
Until I read about Colitis Arthritis, I thought I was NUTS!	NEGATIVE
Wow I am so happy to read all these postings I was just notified that I was misdiagnosed and I never had Ulcerative Colits I have always had Chrons Disease.	NEGATIVE
I am now addicted to Codeine Sulfate.	NEGATIVE
I was given that to keep my bowels thicker.	NEUTRAL
I have seen many gastrointestinal doctors and I think they just love to write prescriptions to keep you quite.	NEGATIVE
When I get down to pick something up it takes me forever to get back up my knees hurt so BAD.	NEGATIVE
My arm and hand go numb and I have constant back pain.	NEGATIVE
They think the back pain is from all the fistulas I now have.	NEGATIVE
Before they diagnosed me with Chrons I was scheduled to go in for surgery on March 30th to make my ostomy bag forever.	NEUTRAL
Now with me being diagnosed with Chrons not sure about the surgery but the doctor still wants to do it.	NEUTRAL
They now want to put me on all types of Chrons medicine.	NEUTRAL
I am frustrated and so upset this has happened to me.	NEGATIVE
Hi, i am a 45 year old woman who was diagnosed with Crohns about 7 years ago but I definitely had it for some time before that.	NEUTRAL
I have also dealt with back pain for the last 20 years and have always dealt with it via chiro, acupuncture, massage, physio, swimming etc.	NEUTRAL
but in the last 6 months i have had some episodes that have been the most painful of my life and have only recently been told that the two are likely related.	NEGATIVE
i have been on Humira for 2 years, infliximab I reacted badly too, and colazide gives me diarhea, and the sulfasalizine type drugs just do bugger all.	NEGATIVE
I want to only to say I empathize with you all.	POSITIVE
To others we look like we are okay, it is hard for them to understand the excrutiating pain we can be in.	NEGATIVE
And i am relieved to discover there is a connection between the two.	POSITIVE
Along with humira (and now celebrex) I take cod liver oil, spirulina, pro biotics, zinc, magnesium orotate.	NEUTRAL
I make sure I eat lots of healthy, grass fed red meat and well cooked vegetables.	NEUTRAL
do not fall for the raw is best line, hard enough for any body to absorb nutrients from raw vegetarian without a rumen let alone us with absorprtion problems.	NEGATIVE
Good luck all.	NOT_LABELED
I was diagnosed with Crohns Disease at age 30 (which was 5 years ago).	NEUTRAL
I am about 15 to 20lbs overweight ...	NEGATIVE
so i could stand to lose weight.	NEUTRAL
My symptoms are not necessarily all typical from what i have been told.	NEUTRAL
I suffer from flare ups consisting of mild constipation, moderate abdominal cramps, & occasional nausea.	NEGATIVE
My worse symptom by far is extreme Joint Pain.	NEGATIVE
I do not have RA or arthritis according to my MD.	POSITIVE
She tells me that it the pain is directly related to what is happening with my colon.	NEUTRAL
I have significant narrowing in the last part of my small intestine & acscending colon.	NEUTRAL
i am told that it is time for surgical intervention.	NEUTRAL
But i am very scared & have put it off for 5 months now...entocort / pentasa combo does not help & the MD said no need to try other drugs at this point...have surgery.	NEGATIVE
Would love to know if removal of narrowed colon would help ease joint pain ...	NEUTRAL
Most nights i am soaking in HOT baths & taking pain medicines trying to get relief.	NEGATIVE
Its miserable.	NEGATIVE
Very little sleep.	NEGATIVE
Glad to hear i am not crazy.	POSITIVE
The joint pain moves around - hands, knees, ankles, shoulders, etc.	NEUTRAL
Never know where it will be next.	NEUTRAL
Any suggestions on full lapro procedure vs open?	NEUTRAL
Id have to travel to have the lapro surgical method but thinking it would be worth it..	POSITIVE
Best to all.	NOT_LABELED
i am a 51 year old female diagonsed with Crohns last summer.	NEUTRAL
Prior to that I have had bathroom issues for several years.	NEGATIVE
Within the last 4 years I had rt shoulder surgery, but the pain is horrible.	NEGATIVE
The pain starts under rt shoulder blade, radiates down rt side of back and rt side, under rt rib cage, rt abdomen, rt arm and wrist very week and even makes my rt breast hurt.	NEGATIVE
i have tried several medicines nothing seems to help.	NEGATIVE
It seems like the only time I can really get relief is when i have been admitted to hospital (twice) and they pour on the fluids, however short term.	POSITIVE
I thought I was CRAZY.	NEGATIVE
I have a appointment with Gastro shortly.	NEUTRAL
Hopefully they can help with all this crazy pain.	POSITIVE
Wow.	NOT_LABELED
I read this discussion and it could have been parts of my own life!!!	NEUTRAL
I was diagnosed with crohns 17 years ago when I was 19.	NEUTRAL
Spent the first 12 years having the digestive issues most of you guys described, including about a foot of bowel removed (iliem area) when I was 28.	NEUTRAL
For the last 6 years it is been less digestive issues, though they are still there, and more joint issues.	NEGATIVE
I have 3 vertebrae in my lower back that a back doctor told me look like a 90 year old ditch diggers because of the amount of inflammation/arthritis affecting them.	NEGATIVE
My knees, wrists, feet, toes, hips...All can and will ache depending on the day/ moment.	NEGATIVE
I have plantar facitis (especially) - inflamed tendons on the bottom of my feet, supposed gout in my left big toe - but it is ALL inflammation of 1 type or another.	NEUTRAL
i am taking hydromorphcontin every day wondering if i am getting physically dependent on it, but not able to walk properly or ``"manage my life"'' if I do not take it.	NEGATIVE
ie . Too stiff & sore & in too much pain to do simple things like cook, clean, go to the playground with my son (6 years old).	NEGATIVE
I also have a spouse who tells me my pain is mostly ``"in my head"'' & I do not need the pain medicines.	NEGATIVE
I do not get a ``"high"'' from them, take them exactly as prescribed and have stopped taking them only to be unable to sleep & go from bed, straight to sofa in the morning because i am to stiff & sore & in pain to do anything.	NEGATIVE
i have met people with ``"regular"'' arthritis (reumatiod & osteo) and generally the people i have met say they suffer more from stiffnes & with RA deformaties but do not appear to have the ``"traveling"'' inflammation of the joints I do (as in one day my knees are worse, few days later it seems my wrists are worse, my back always hurts).	NEUTRAL
Has any one else run into this?	NEUTRAL
I believe I have a very high pain tolerance laughing out loud after crohns for this long i have only been on regular pain medicines for the last 4 years.	POSITIVE
With the gut pain we can get people with crohns develop a high pain tolerance I believe.	POSITIVE
i have tried humira but reacted to it.	NEGATIVE
I also tried remicade a few years ago but had to stop because I got really run down & sick & could not get healthly again.	NEGATIVE
My gastrio-doc is thinking of remicade again or referring me to a reumatiod arthritis doctor, waiting for blood work to come back.	NEUTRAL
In addition to humira (allerigic), remicade, i have been on pentasa, salofalk (especially?), entocort & prednisone, (so sick of cortisteroids), & immurane (got very very sick from).	NEGATIVE
Anyway not that I wish these problems on anyone but it is nice to hear about them & know a person is not the only one going through it, especially when (for me at least) the people closest to me really have no idea what it is like.	POSITIVE
Thanks for letting me ramble.	POSITIVE
Hi, I was diagnosed with crohns disease in 2003, I had one colon resection in 2006.	NEUTRAL
I am in pain everyday, and I too think that I am crazy, and would not ever wish this debilitating disease on no one.	NEGATIVE
I am always reading to find out more about this disease.	NEUTRAL
I change my diet from time to time, but it is never the same.	NEUTRAL
What I ate last week, I cannot eat this week.	NEGATIVE
I get sick just thinking about what to eat and what not to eat.	NEGATIVE
I have taken Asacol, Imuran, prednisone, entocort, and the list goes on.	NEUTRAL
I try to pray daily, but my mind is so much on the pain, I forget to sometimes.	NEGATIVE
I ache through out my whole body daily, I go through the pain and every other night I take a vicodin to help me sleep.	NEGATIVE
( do not want to become addicted) tylenol nor tylenol PM works for me anymore.	NEGATIVE
I have Rheumatoid arthritis stemming from the crohns.	NEUTRAL
Sometime I do not even know what to say or how to describe my pain anymore, because it just seems as though people do not believe you, and I guess because I still have to get up and do what I have to do; cook, clean, wash, drive kids, which is dangerous because my legs sometimes lock up on me and I have to pull over until the pain goes away.	NEGATIVE
I feel for everyone on this panel and I understand the misery of Crohns, we are not CRAZY, just in constant PAIN.	NEGATIVE
Hi, I am back, (Nace1) my first post was June 7th 2010, where I spoke about having had Crohns for some 26/7 years , 3 operations, (bowel resections) and at date of that post 4 months of severe migrating joint pain.	NEGATIVE
So here we are 14 months later with an update: Many consultations later with both Gastro & Reumatologist, Reumo is baffled by what is going on as many tests show no degradation associated with arthritis but believes in my pain and has seen physical and photographic evidence of swellings	NEUTRAL
In summary thinks its connected to the Crohns, somehow?	NEUTRAL
Gastro is convinced the Crohns is under control and therefore joint & other areas with these symptoms are not connected?	NEUTRAL
so, not the Crohns?	NEUTRAL
So neither of them are taking any responsibility, they can't both be right unless it is something completely different?	NEUTRAL
I am so so frustrated, I am sure I could handle the pain and disability better if I new what it is and what to expect, I am now unable to work full time or plan anything as I do not know from one day to the next how I am going to be.	NEGATIVE
I do not know the answers, but it does help to speak with people who have an idea what I am going through, so thanks for that at least guys, actually I think mostly ladies on this forum, I feel for you all.	POSITIVE
Paul.	NOT_LABELED
Hi, Yes, it is probably all related, because Crohns and arthritis are both auto-immune conditions, where the bodys immune system attacks the body itself.	NEUTRAL
I did it the other way round, i have had arthritis for many years, since my 30s (i am now 61) and I got Crohns at age 54.	NEUTRAL
It was blamed on the anti-inflammatory drugs I had been taking for years.	NEGATIVE
I have especially bad arthritis in my spine and cannot now take much in the way of anti-inflammatory, only 1 tab of naproxen a day, but it does take the edge off.	NEGATIVE
what is really good for joints is green-lipped mussel supplement, freely available.	POSITIVE
I got on to it because the vet gave one of our dogs some for hip arthritis and within a couple of days she was jumping round like a puppy, so I thought if it works for the dog, it is got to help me too!	POSITIVE
Give that a try, it does not seem to irritate the gut.	POSITIVE
Hey this i think is defiantly crohns related ...	NEUTRAL
i am a 30 year old female who was diagnosed with Crohns earlier this year & also diagnosed with Psoriatic Arthritis a few months ago.	NEUTRAL
i am in pain all the time & it *****, i know how it feels ...	NEGATIVE
I too also have to go see a Reumatologist for the Psoriatic Arthritis & i am taking Embrel Shots 2x a week for it because i have plaque masses on my hands, elbows, knees, back & the whole top of my right foot & those are all the places i also have joint pain too: (They itch all the time, they are red & swollen but i not only do i feel the pain on the outside of my skin, i feel it in my joints too.	NEGATIVE
Hi I have Crohns disease and have just started getting a lot of joint pain, mainly in my right hip, its so bad some times i am unable to weight bare on it, Any advice?	NEGATIVE
Well like the most of you i have been on this roller coaster for 18 years now with Colitis, my hips and knees were getting so sore I was having trouble trying to sleep.	NEGATIVE
After feeling my gastrointestinal was enjoying his work just a little too much and feeling embarrassed to go for appointments I switched to a new gastrointestinal who after five years has never given me a rectal exam in his office.	NEGATIVE
He put me on 300 mg of Celebrix/ day and after one month the only time my hips bother me is if I walk further than I should and yes definitely related to Chrons and Colitis.	POSITIVE
Now there are two different dosages depending on which Arthritis your gastrointestinal puts down you are being treated for, the milder sorry if that sounds insensitive only allows 200 mg for insurance purposes where the nastier form allows for 400 mg.	NEUTRAL
i am sorry I have not got the names I know one is Rumathoid but I think you should get the idea.	NEUTRAL
so my gastrointestinal gives me 300 mg because 200 would not do it.	NEUTRAL
Good Luck to you all and may God Bless.	POSITIVE
Rick.	NOT_LABELED
Trina is that what it is called green-lipped mussel supplement, from what I know Celebrex is better than Naproxin and does not bother me at all at 300 mg / day, my hips and knees have finally stopped bothering me.	POSITIVE
My Colitis has been contributed to my anti inflamatory Feldene 200 mg / day I was taking following three failed back surgeries.	NEUTRAL
Strange they gave me the good old reliable strong one and really messed me up.	NEGATIVE
Its funny our pets get better medicines than we do.	NEGATIVE
I just want to make sure of the name of the other, they will not give my wife the same as me so she still suffers, maybe it will work for her too Thank in advance.	NEGATIVE
Rick.	NOT_LABELED
Hi, i have just started on low dose naltrexone and have relief of joint pains for the first time!	POSITIVE
Please go to the website -URL- and look up the information.	NEUTRAL
i am so grateful I did.	POSITIVE
All the best, S.	NOT_LABELED
Hi, I was diagnosed with UC in 2007 and have had a couple bad flares, bad enough to be hospitalized for.	NEGATIVE
I have seen major improvement in my digestion since I started the Specific Carbohydrate Diet (SCD) via Elaine Gottshalls book Breaking the Vicious Cycle.	POSITIVE
I still have some joint pains buy they seem to be improving.	POSITIVE
Epsom salts baths add some relief.	POSITIVE
Mostly my knee and elbow right now.	NEUTRAL
I am not on any medicines and do not want to take any so i am looking for relief naturally.	NEUTRAL
It seems excersize helps some too.	POSITIVE
Thanks, don't M.	NOT_LABELED
I was diagnosed with UC 15 years ago that never went into remission and I had a colectomy with j-pouch surgery 13 years ago.	NEGATIVE
That took care of the intestinal issues, but I have had fatigue and joint/muscle aches all along the way and they have recently gotten worse.	NEGATIVE
The slightest exertion can leave me achy, weak, nauseous, and blurred vision for 1-3 days after.	NEGATIVE
Usually i am battling fatigue and aches on a regular basis, but it gets a lot worse after any exertion.	NEGATIVE
All blood work comes back normal.	POSITIVE
Doctor has me on fish oil and anti-depressants.	NEUTRAL
They help a little.	POSITIVE
So i am another example of this IBD-related pain syndrome.	NEUTRAL
Feeling pretty hopeless but plan to try arthritis medicine like Celebrex if doctor agrees.	NEGATIVE
Your symptoms are the same as mine.	NEUTRAL
My bowels are in remission, but I suffer with fistulas.	NEGATIVE
I have been having the same arthritis symptoms for the past year, severe.	NEGATIVE
Moves from joint to joint severely every day.	NEGATIVE
Every joint, from my toes, feet, ankles, knees, shoulders, elbows, wrists, fingers.	NEGATIVE
It seems to be leaving me with nerve damage.	NEGATIVE
Now have numbness below one knee and all fingers in left hand.	NEGATIVE
My right hand has nerves pinching currently and unable to straighten my finger.	NEGATIVE
Also affects my tendons.	NEUTRAL
I also feel it must be more than just arthritis.	NEUTRAL
I am only 50 and feel I will have to get on disability soon if I do not get this under control.	NEGATIVE
What the heck!!!!	NOT_LABELED
Did you ever get a doctors response?	NEUTRAL
Try eliminating sugars / Doing so saved my joints.	POSITIVE
i am in my 30s and i have had moderate / sever ulcerative colitis for 9 years and about 2 or 3 years after my first symptoms I started experiencing severe joint pain that would migrate from joint to joint (knees, knuckles, shoulders, toes, ankles, inner hip/groin, as well as in my back and chest muscles.	NEGATIVE
The pain would last severely in one joint/area for a 1-4 days often being debilitating (sleepless nights, extreme pain, inability to use joint, sometimes, hot swollen joint) then would travel to another joint usually then travel to the other or go dormant for a time then flair up again.	NEGATIVE
After almost giving up on trying to fix the problem I saw a pattern (a few days after gorging on Halloween candy) that the flairs were directly associated with my consumption of processed sugars.	NEUTRAL
It was amazing after cutting candy, soda, and high fructose corn syrup and other processed sugars out of my diet for about a month the joint pain stopped completely.	POSITIVE
I found can eat natural sugars no problem such as in fruit and juice and have no problem.	POSITIVE
Once again the pain literally stopped after about a month and has not returned for now years.	POSITIVE
However, if I stray and start to each too much processed sugars I can feel it creeping in once in full force for a time after straying from my strict no sugar rule).	NEGATIVE
Those little reminders and one large reminder have allowed me to stay ``"bad"'' sugar free and pain free.	NEUTRAL
Before when I had the pain I used high and low doses of prednizone but even prednizone did not completely help me.	NEGATIVE
It was not until I stopped the sugar and stayed off it that I found relief.	POSITIVE
Also, i have been able to stay predizone free as well).	POSITIVE
Although my colitis is still an issue (mostly managed by Asocal / Asathiaprine) the joint pain is past.	NEUTRAL
I hope this helps and I highly recommend you try this as it saved me so much pain.	POSITIVE
On a related note I also try to stay away from too much fake sugars (diet drinks, etc) as I have found that these have caused me some trouble although not nearly as much as processed sugars.	NEUTRAL
Good luck!!!	NOT_LABELED
Try eliminating sugars / Doing so saved my joints.	POSITIVE
i am in my 30s and i have had moderate / sever ulcerative colitis for 9 years and about 2 or 3 years after my first symptoms I started experiencing severe joint pain that would migrate from joint to joint (knees, knuckles, shoulders, toes, ankles, inner hip/groin, as well as in my back and chest muscles.	NEGATIVE
The pain would last severely in one joint/area for a 1-4 days often being debilitating (sleepless nights, extreme pain, inability to use joint, sometimes, hot swollen joint) then would travel to another joint usually then travel to the other or go dormant for a time then flair up again.	NEGATIVE
After almost giving up on trying to fix the problem I saw a pattern (a few days after gorging on Halloween candy) that the flairs were directly associated with my consumption of processed sugars.	NEUTRAL
It was amazing after cutting candy, soda, and high fructose corn syrup and other processed sugars out of my diet for about a month the joint pain stopped completely.	POSITIVE
I found can eat natural sugars no problem such as in fruit and juice and have no problem.	POSITIVE
Once again the pain literally stopped after about a month and has not returned for now years.	POSITIVE
However, if I stray and start to each too much processed sugars I can feel it creeping in once in full force for a time after straying from my strict no sugar rule).	NEGATIVE
Those little reminders and one large reminder have allowed me to stay ``"bad"'' sugar free and pain free.	NEUTRAL
Before when I had the pain I used high and low doses of prednizone but even prednizone did not completely help me.	NEGATIVE
It was not until I stopped the sugar and stayed off it that I found relief.	POSITIVE
Also, i have been able to stay predizone free as well).	POSITIVE
Although my colitis is still an issue (mostly managed by Asocal / Asathiaprine) the joint pain is past.	NEUTRAL
I hope this helps and I highly recommend you try this as it saved me so much pain.	POSITIVE
On a related note I also try to stay away from too much fake sugars (diet drinks, etc) as I have found that these have caused me some trouble although not nearly as much as processed sugars.	NEUTRAL
Good luck!!!	NOT_LABELED
Try eliminating sugars / Doing so saved my joints.	POSITIVE
i am in my 30s and i have had moderate / sever ocerative colitis for 9 years and about 2 or 3 years after my first symptoms I started experiencing severe joint pain that would migrate from joint to joint (knees, knuckles, shoulders, toes, ankles, inner hip/groin, as well as in my back and chest muscles.	NEGATIVE
The pain would last severely in one joint/area for a 1-4 days often being debilitating (sleepless nights, extreme pain, inability to use joint) then would travel to another joint usually then travel to the other or go dormant for a time then flair up again.	NEGATIVE
After almost giving up on trying to fix the problem I saw a pattern (a few days after gorging on Halloween candy) that the flairs were directly associated with my consumption of processed sugars.	NEUTRAL
It was amazing after cutting candy, soda, and high fructose corn syrup and other processed sugars out of my diet for about a month the joint pain stopped completely.	POSITIVE
I found can eat natural sugars no problem such as in fruit and juice and have no problem.	POSITIVE
Once again the pain literally stopped after about a month and has not returned for now years.	POSITIVE
However, if I stray and start to each too much processed sugars I can feel it creeping in once in full force for a time after straying from my strict no sugar rule).	NEGATIVE
Those little reminders and one large reminder have allowed me to stay ``"bad"'' sugar free and pain free.	NEUTRAL
Before when I had the pain I used high and low doses of prednizone but even prednizone did not completely help me.	NEGATIVE
It was not until I stopped the sugar and stayed off it that I found relief.	POSITIVE
Also, i have been able to stay predizone free as well).	POSITIVE
Although my colitis is still an issue (mostly managed by Asocal / Asathiaprine) the joint pain is past.	NEUTRAL
I hope this helps and I highly recommend you try this as it saved me so much pain.	POSITIVE
On a related note I also try to stay away from too much fake sugars (diet drinks, etc) as I have found that these have caused me some trouble although not nearly as much as processed sugars.	NEUTRAL
Good luck!!!	NOT_LABELED
Try eliminating sugars / Doing so saved my joints.	POSITIVE
i am in my 30s and i have had moderate / sever ocerative colitis for 9 years and about 2 or 3 years after my first symptoms I started experiencing severe joint pain that would migrate from joint to joint (knees, knuckles, shoulders, toes, ankles, inner hip/groin, as well as in my back and chest muscles.	NEGATIVE
The pain would last severely in one joint/area for a 1-4 days often being debilitating (sleepless nights, extreme pain, inability to use joint) then would travel to another joint usually then travel to the other or go dormant for a time then flair up again.	NEGATIVE
After almost giving up on trying to fix the problem I saw a pattern (a few days after gorging on Halloween candy) that the flairs were directly associated with my consumption of processed sugars.	NEUTRAL
It was amazing after cutting candy, soda, and high fructose corn syrup and other processed sugars out of my diet for about a month the joint pain stopped completely.	POSITIVE
I found can eat natural sugars no problem such as in fruit and juice and have no problem.	POSITIVE
Once again the pain literally stopped after about a month and has not returned for now years.	POSITIVE
However, if I stray and start to each too much processed sugars I can feel it creeping in once in full force for a time after straying from my strict no sugar rule).	NEGATIVE
Those little reminders and one large reminder have allowed me to stay ``"bad"'' sugar free and pain free.	NEUTRAL
Before when I had the pain I used high and low doses of prednizone but even prednizone did not completely help me.	NEGATIVE
It was not until I stopped the sugar and stayed off it that I found relief.	POSITIVE
Also, i have been able to stay predizone free as well).	POSITIVE
Although my colitis is still an issue (mostly managed by Asocal / Asathiaprine) the joint pain is past.	NEUTRAL
I hope this helps and I highly recommend you try this as it saved me so much pain.	POSITIVE
On a related note I also try to stay away from too much fake sugars (diet drinks, etc) as I have found that these have caused me some trouble although not nearly as much as processed sugars.	NEUTRAL
Good luck!!!	NOT_LABELED
Hi everyone, I have had moderate U.C . for 8 years now and I have taken prednisolone tablets (steroids) about 3 times over that timeframe, but generally I control my U.C by using prednisolone enemas which I am doing at the moment.	NEUTRAL
i am relatively healthy despite needing to go about 4 times a day but i am never really in remission.	NEUTRAL
Anyway my question is are there any other women experiencing a little bit of HAIR LOSS as I find my hair is thinning around my crown abit, and my part seems to be widening.	NEUTRAL
I am the type of person who is also a worrier and a stresshead at times, so I do not know whether it is to do with that as well.	NEUTRAL
Anyway it would be great if you could let me know.	POSITIVE
Ask for a hormone test.	NEUTRAL
Your hair loss does not have to be a part of the UC.	NEUTRAL
In any case patchy hair loss is a symptom that should be looked into.	NEUTRAL
I am a hairdresser and I have noticed that women with UC because of lack of nutrion lose Can have hair loss.	NEUTRAL
You do not absorb enough vitiamns.	NEGATIVE
So you might want to take some.	NEUTRAL
Also it could be hormones like was suggested or it could be a thyroid problem.	NEUTRAL
If you are stressed a lot its likely to be that also.	NEUTRAL
When you get stressed your scalp tightens up and it cuts the circulation off to the hair follicals and your hair can get dry and brittle.	NEUTRAL
so stimulation to the scalp helps hair growth and health.	NEUTRAL
You might have some blood work next time you go to the doctor just to rule out all the other stuff mentioned.	NEUTRAL
I am 40 years old and was recently diagnosed with UC (in December).	NEUTRAL
I am taking Lialda and Iron pills.	NEUTRAL
Since the treatments began (and believe me I was stressed prior to then) I am having significant hair loss.	NEGATIVE
I have always had an overabundance of hair, so initially this did not concern me.	NEUTRAL
However, I have just started to notice what you mention.	NEUTRAL
Widening part, small bald patch at the crown.	NEGATIVE
This does concern me!	NEGATIVE
I think vitamin supplements are worth starting and will do that right away.	NEUTRAL
I have also read articles about lack of iron leading to hair loss - but do not you think my twice daily iron supplement would prevent this?	NEUTRAL
In any case, I would be interested to know if you find something that works and Ill do the same.	NEUTRAL
I have had marijuana hair loss in the same pattern (i feel like i have little bald devil horns and i am going to need a wig soon!) and have also always had TONS of hair and stress so I did iron/multvitamin and other vitamin regimens for the last 2 years straight, it has not helped my hair one bit.	NEGATIVE
I have tried being on anti-anxiety/anti-depressants to see if the lack of stress would help,1 year on those, no help at all.	NEGATIVE
Now my eyebrows are starting to go rapidly, the entire hair loss thing came on suddenly and like WiLdFiRe!	POSITIVE
Multiple doctors say they have no clue, a friend suggested I go see a Dermatologist, I do not *think* i have ever done a hormone test or if that would even provide a solution.I do not want to go bald and then find out what is wrong and then be told it is too late to really grow any of the hair back because of how long it is been happening for.Ya know?	NEUTRAL
i am so sad because i feel like i resemble a chemotherapy session patient.I cannot do my hair anymore because its like paper thing strings.	NEGATIVE
i am 22 years old and feel 92.	NEGATIVE
Can anyone provide a success story on this U.C . related hair loss?	NEUTRAL
Please help!	NOT_LABELED
: (	NOT_LABELED
Hi, I was diagnosed with UC over a year ago, and have gone through a plethora of different drugs to find something which works (relatively ...), among which Asacol and Prednisone, both of which are having a huge effect on my hair - that is I lose quite a lot.	NEGATIVE
I am quite young (22) so it has nothing to do with hormones etc.	NEUTRAL
My physician told me it was mostly stress (yes, like this is gonna na help...anyone with UC knows how stress is hard to control when you are sick and bothered about it!), but my hairdresser aunt actually gave me a great tip - Zinc!	POSITIVE
Generally I find that taking multi-vitamins help me, if only because I know with my bowel habits I do not absorb enough vitamins, but Zinc had a great effect on my hair.	POSITIVE
It is growing again so I am starting to get some thickness back, though I have illusions that it will be back to how it was before.	POSITIVE
Anyway, I took Zinc , 50mg tablets once a day, and in 1 week I felt a difference, and I stopped taking it and the hair still does not go off.	POSITIVE
It is worth a try at the very least then!	NEUTRAL
I have uc for 2 years i took the same medication for 45 days only, since then I have thin and dry hair.	NEGATIVE
I have a friend who has a similar problem and wwith the hair loss.	NEUTRAL
She is in her 50s.	NEUTRAL
She recently started drinking an organic supplement called vemma.	NEUTRAL
This has turned her symptoms around and not only is her hair growing back, it is regaining its color.	POSITIVE
She has been completely white headed and it turning back to dark brown, She is thrilled.	POSITIVE
One of the other benefits she is getting, is she has a lot more energy to go with.	POSITIVE
Something to think about.	NEUTRAL
Check out these websites: vmatestimoials.com vemmatestimonials.com miracles of mangosteen and minerals.com my email *** @ **** This is about wellness and prevention.	NEUTRAL
hi, my daughter is suffering from ulcerative colitis, she is only 7 years old, and for the last 1 year she is taking prednisolone.	NEUTRAL
I want to know is this hair loss is due to excessive medicine intake or due to some other reasons?	NEUTRAL
i have had UC for 2 years and it is been pretty much under control the past 6 months.	POSITIVE
I was first placed on Asacol, that and drugs in the same category do because hair loss.	NEGATIVE
Switched to Sulfasalazine and the hair loss stopped, but in the last couple months started losing hair again and have a bald patch on the back of my head.	NEGATIVE
i am 25 and this is NOT a side effect of sulfasalazine, so I guess this is just what many uc sufferers have to deal with.	NEUTRAL
made a dr. appointment just in case though.	NEUTRAL
So sorry for eveyones troubles, wish you all the best.	NEUTRAL
Hair loss is a side effect from Mesalamine, which is an NSAID (non-steroid anti inflammatory).	NEGATIVE
Treatment with NSAIDs creates a shock to your system which transforms hairs in the growing stage to the dormant stage (for a few months) and then the shedding stage.	NEUTRAL
This is why you do not see the shedding until a few months in.	NEUTRAL
The damage is done when the hair is rendered dormant, but the shedding that follows takes a few months.	NEUTRAL
Do some research on NSAIDs and hair loss.	NEUTRAL
I am a 31-year-old woman who has had U.C . for three years.	NEUTRAL
I was taking my regular (doctor recommended) vitamins: fish oil, calcium, vitamin D, vitamin C, magnesium; and stopped taking them because I was tired of taking so many pills every day, along with Asacol.	NEGATIVE
Soon I developed severe pneumonia, was in the hospital for two weeks, had lots of chest x-rays, and my hair began just dropping out.	NEGATIVE
Then the remaining hairs were quite thin and showed a piment-less stripe all around.	NEGATIVE
The stripe makes it easy to see how far my hair has grown in a year--3.5 , compared to the normal 6 .	NEGATIVE
As soon as I went back on my vitamins, the hair loss desisted and the lost hairs began growing back right away.	POSITIVE
In other words, take vitamins!	NEUTRAL
And if your U.C . is still not under control, ask your doctor about stepping up your treatment to a medication like Imuran (Azathioprine), an immunosuppressant, and go to a bowel disease specialist.	NEUTRAL
Taking these steps has turned my life around  I feel better than I have in three years!	POSITIVE
Just do not skip doses.	NEUTRAL
Do you know if the hair loss just a temporaray side effect from the mesalamine?	NEUTRAL
i am taking it (Lialda) and noticed my hair really shedding now the past week or two.	NEGATIVE
i have been on the Lialda for about 4 months.	NEUTRAL
I hope it is not permanent.	NEUTRAL
I would suggest assisting your circulation with L-argimine and ginkgo biloba.	NEUTRAL
I have Celiac disease, so I also have absorptive problems.	NEGATIVE
I take lots of vitamins and minerals and eat gluten-free and eat healthy.	NEUTRAL
But adding these two aids to circulation has me looking great (skin).	POSITIVE
So between those and adding a shower water filter to take out both chlorine and chloramine that my city adds to the water, my skin and hair are optimized.	POSITIVE
My hair looks healthy and fuller, although it is only been a few weeks.	POSITIVE
Lialda and any other type of mesalamine do not because hair loss.	POSITIVE
Steroids and malnutrition do.	NEGATIVE
Yes, Mesalamine, Lialda, Asacol etc., do not correlate with hair loss.	POSITIVE
Prednisone, Cortisone, etc . and stress do.	NEUTRAL
It can be either and at 7, I would ask a doctor.	NEUTRAL
Take vitamins.	NEUTRAL
It was only a matter of time and not your medicine.	NEUTRAL
Has anyone experienced hair loss with using 6mp for UC.	NEUTRAL
i have been on it for 2 months and noticed hair loss in the last three weeks.	NEGATIVE
Does this ever stop?	NEUTRAL
